sseqid	qseqid	sequence	query_start	query_end	seq_start	seq_end	length
2G5Z3:00649:03586	INITIAL_QUERY	CCGACGAGCGGCTGAATGTGACAGAGGAGCCGACGTCTAACGACAAGACCAGGGCCTGAGCATCCAGTCCACGCTCACGGAGCCAAGCAGGTCACCTGGAGAGTTAGAGACAGTGGAGTTGGGAGAGCTTGACTCTCGAGCTGACTCTGCGTCTGAGTCACTTGCCAGCTCAAGCTG	457	467	40	30	-10
2S43D:01868:10548	INITIAL_QUERY	CTGGTTCCACCTCATCATTCTCCAGTAGCCAAAGATCAAGGCCCGATGCCACAGACAACATGCTGTACCCCGACAGTCCCGGCGGGCAGGTTCGCTTGTAGTCGATGGGACCGTAGCCCCTGGCGGGGGCATTGTCCTGCCTGAGGGAACGGGTGTTGACATACCTTCGAAGATTCTGCAGAGTTTCTCTGGGCAGTTAATGGCTTCAGCCTGAGAGGCCTACTTTATTTCTTGAGAGTGGGTCTGAAGTTAGCTCGTGACTTGTCTTTGGCAGGACTCTGCTTGCATAGAATTACGACTGCTAGCCACAGCTACAGTGAGGATGTTAAAATGCAGTTTAATCAGATGCCATTTTTTTGTTCAACAATTTTAATTTATTGGAATTGACACAATTTTTTAATTATGCGGGTCGGCTGGGGCTCAGACCTTCATCTCCAAGGAGGTCCTTAGAGGGTGGTGGGATGCAGCACCTGAGTTCTGCTCTGAGTCCCTCTGTTTTCTCCAGCTCCTCCTCCAAGCTCGATCTACACAAAATCTGTGCCTTGTACTGGTCGCCATGGGCGTGCCGTGCAATGGTGATGGGCTTGGTCCACC	566	576	551	541	-10
2S43D:00759:09571	INITIAL_QUERY	GGCTTATATTATGGATCATATACATTTATAGAAACCTGAAACATTGGAGTACTTCTACTGTTCGCAGTCATAGCCACAGCATTTATAGGCTACGTCCTTCCATGAGGACAAATATCATTCTGAGGTGCCACAGTTATTACAAACCTCCTACTCAGTC	67	77	65	55	-10
2S43D:09033:12621	INITIAL_QUERY	GGATCGTCCTCTGTACCCCTGGTTGCACAGGGTAGATCAGGCTGGTTTCGAACTTAAGAGATCTCATTGCCCCTGCCTCCGGGGTGCTGGTAGTCTTTTGTGCTACCATTGCCTGGTTTTTGTATTGTGATTTATCTCTTCGTCGCAGGGTTATCCTGACGCCCCTGAGGGGGAGGGATTTGATGGACTAAATTCCCATTTAGGGCCCATCGCCCCCTCGTCAGAAAGGCCTTGTCCTTGCAGGCTTCCAAGACACCGCTAAGGTTAGCCTTTGGTTGGAGACAAGTGCTCTAGCCCAGACACTGGAGTAAGGCGCTGAGACCAACGAGGCAGGCCAAGATGGAGATCTATGGAAGGCCCTTGCTGGCGGAAGTGATCAAAACTCATCCAGTACTTCCACAAGACTGTCTCGATTTGATTGACCAGAAGGTGTACGAGCTTCAGGCCAGCCGCGTCTCGAGTATGTCATGACAGAAGGTGTACGAGATCCAGGTACATTACGAGACAGCTGGACCAAGCTAACTGAAAGGTTCTTATTACTAGAGGTAGAAATACAGGCAATATACTATTACGGCAACAACCAGATCAATTATACAGTTAAGTAATTTTTTCTGTAACAACCAAAATGGATAATGCCACTCCAGGCTGTCCGTTGGAATTGTGTGGAAGCTCAGCTGTGTCAGCGCACAGCAGGACGGGGAGCAGCCAGGGGCAGGGCGCGGGGGTGGCAGCCCCTTCGCCACCACGATCAAATTGGACTTTTCCTTTCGGG	122	132	677	687	10
2S43D:02267:06838	INITIAL_QUERY	GCTCACTTGCCCACTTCCTTCCACAAGGAACTCCAATTTCACTAATTCCAATACTTATTATTATTGAAACAATTAGCCTATTTATTCAACCAAATGACATTAGCAGTCCGGCTTACAGCTAACATTACTGCAGGACA	183	193	126	136	10
2S43D:01408:07960	INITIAL_QUERY	CTGGTTCCGTGCTTTCCAACGCTTAACATCCTCTTCCAGTAGCTTCTTTTCTGCCTGGAGCATACCGCTTTTCTCACTCAGCTCAGCATTGGCTTCTATGCTTTTGTAACTTTTGATGATCATGACACAGTTGATAAAATTGTTGTTCAGAAATACCACACTATTAATGGGCATAATTGTGAAGTGAAAAAGGCCCTTTCTAAACAAGAGATGCAGGCTGGTTGTGGAGTAGATAGAAAAGTGAGCTACAGAAATGCAAACTGAAAGGTCAGAAGTACGGAAGTGGTTGTATATGCCCTATAATCCAAGCCCTTGACTGATGGAAGGGTATAGCCAGTTTGAGCTACGAAATGAGAACAGTGGA	609	619	64	74	10
2G5Z3:08090:01694	INITIAL_QUERY	CTGGGACGGCCCGCTGCCAACACGAAGATTGGCCCTCGCCGCATACACACAGTCCGAGTTCGAGGAGGCAATAAGAAGTACCGTGCCCTGAGATTGGATGTGGGGAACTTTTCATGCAATGCGGCGGCTGCATACGCTTGATCCGGCTACCTGCCCATTCGACCACCAAGCGAAACATCGCATCGAGCGAGCACGTACTCGGATGGAAGCCGGTCTTGTCGATCAGGATGATCTGGACGAAGAGGCATCAGGGCTCGA	359	490	113	244	131
2G5Z3:05145:01866	INITIAL_QUERY	CCGGTGGGGCGGGGGGCCCGGACACTCGGGGGGGCCGGCGGCGGCGGCGACTCTGGACGCGAGCCGGCCCTGCAGAAGAATCCATAGAGAACATGGGCACAACAATCAAATAAAATCGCAAAAATGCAAAAAAAAAATCCTAACTCAAAACATCCAGGAAATCCAGGACACAAACCTACGGATAATAGGAATAGATGACAATGAAGATTTCAACTTAAAGGGATCCAGCTAAAAGTATCTTACAAATCAAAATT	76	87	93	104	11
2S43D:09191:05461	INITIAL_QUERY	CCACCGCATACTCCAACGGTTTCCTGGTCCCTTGTTTCCAGGTCACCTTTATCCCCTGGGCTCCCATCAGCACTGCTCACTCCCACGTCACAGGGGGCAGGATTCTGGAGCTGGAAGTGGGAGA	300	310	93	103	10
2G5Z3:00179:11389	INITIAL_QUERY	GGCACGGGCCTATTTACAAGGGACTTGGTGAATCGGAAAGGGTGAGAGCAGGGAGGGGGATCCCTGGCAGAGCCGTAATATTCCTATGTCCCTGGCAGCTCAAGTCCTGCTGCCACCCCAGGGGAGAGGCCCTGAGGCTGAGCTCCTAGCCAGTACTGTGACAGCACCCCTCGGAGCTCTCCTCCCCAACAGGTACAGATAAAGGTGCTTGTTCAAGACCTGGGACCCATTTGTGAGGAAAAGACTGACCTAGCCCAAAGCTGATCCCATTCAGCCTTTGCTCTATGTAGTGTAGCGCTCTCGTCTACGTCTCTGTTCTCTGTCATGTGACCCTGTGCCCCACTTCCTGGGGTGCCTATGTGCCTGGTTCATGGCCTTGGAGCCATGGTCAGGTCACAGTCCGGTGCCTTCCACCCCTATGGCAAGGCGCCCTCCTTGGCCTACCACACGCTGCCTCCAGGCTTAGACCTGGCTTCACCGCCA	165	175	398	408	10
2S43D:03492:07354	INITIAL_QUERY	GAGGCTCCCACCTAACACCAACGATGAGGTGGATGAAGATCCCACTGGAAACAAAGCCCTGTGGGACCGGGGCTTGCTCAATGGGGCTTCACAGAAGGCAGAGGTCATCATGAACTACCACGTTGGAGAGACCGTGCTGTCGCTACAGAAGACCACACTGATCCCTGGAGGCTCAGAGTCCCTTGTCTAAAATTGTTCGTGACATAAAGGAGAAGCTGTGCTATGTTGCCCTGGATTTTGAGCAAGAAATGGCTACTGCTGCATCATCTTCCTCCTTGGAGAAGAGTTACGAGCTGCCCGACGGGCAGGTGATCACCATTGGCAATGAGAATGGCAAGACCAGCAAGAAGATCACCATTTCCGACTGTGGACAGCTCTAATTTCTTTTGACTTGCGGGCATTTTACCCATCAAACCTTATTCCTTCTGTAGCTCAGGAGAGCGTCCACACATGAAGGCTCACAACCATCTGTACAGCTACAGTGTACTCACACATATAAAATTTAAAAAAAAAAAAAGCCAACATTCGACAGGATAAAGGTGTCCAAGGCAGCTGCTGACTTGATGGCCTACTGTGAGGACACCATGTCCAAGGAAGGACCCTCCTGCTGACCCCCAGTCCCGCCTCAAGAAAACCCCATTTCGGGAGAAGAAAGTTCAGTGGACTCTTTCTGGATGTTGTAGTCTGACAGGGTGCGGCCATCTTCCAGCTGCTTGCCTGCAAAGATCAGCCTCTGCTGGTCAGGGGGGGATGCCCTCCTTGTCCTGGATCTTTGCCTTGACATTCTCAATGGAAAAACAGGACAGCCATGATCTCGGCAGCGCTGCAGCATGATGTGGGGTGGCCTGAGCTGCCGCGAGTGCGAGGCTAGGATGGACTGAGCGCAGGCGATTGGCTGTGTCCTTCAGGGCCTGGAGCTTCTGA	539	549	294	304	10
2S43D:03492:07354	INITIAL_QUERY	GAGGCTCCCACCTAACACCAACGATGAGGTGGATGAAGATCCCACTGGAAACAAAGCCCTGTGGGACCGGGGCTTGCTCAATGGGGCTTCACAGAAGGCAGAGGTCATCATGAACTACCACGTTGGAGAGACCGTGCTGTCGCTACAGAAGACCACACTGATCCCTGGAGGCTCAGAGTCCCTTGTCTAAAATTGTTCGTGACATAAAGGAGAAGCTGTGCTATGTTGCCCTGGATTTTGAGCAAGAAATGGCTACTGCTGCATCATCTTCCTCCTTGGAGAAGAGTTACGAGCTGCCCGACGGGCAGGTGATCACCATTGGCAATGAGAATGGCAAGACCAGCAAGAAGATCACCATTTCCGACTGTGGACAGCTCTAATTTCTTTTGACTTGCGGGCATTTTACCCATCAAACCTTATTCCTTCTGTAGCTCAGGAGAGCGTCCACACATGAAGGCTCACAACCATCTGTACAGCTACAGTGTACTCACACATATAAAATTTAAAAAAAAAAAAAGCCAACATTCGACAGGATAAAGGTGTCCAAGGCAGCTGCTGACTTGATGGCCTACTGTGAGGACACCATGTCCAAGGAAGGACCCTCCTGCTGACCCCCAGTCCCGCCTCAAGAAAACCCCATTTCGGGAGAAGAAAGTTCAGTGGACTCTTTCTGGATGTTGTAGTCTGACAGGGTGCGGCCATCTTCCAGCTGCTTGCCTGCAAAGATCAGCCTCTGCTGGTCAGGGGGGGATGCCCTCCTTGTCCTGGATCTTTGCCTTGACATTCTCAATGGAAAAACAGGACAGCCATGATCTCGGCAGCGCTGCAGCATGATGTGGGGTGGCCTGAGCTGCCGCGAGTGCGAGGCTAGGATGGACTGAGCGCAGGCGATTGGCTGTGTCCTTCAGGGCCTGGAGCTTCTGA	349	359	803	793	-10
2S43D:02502:03709	INITIAL_QUERY	CTGTTGGGTCAGAACCAGGGCCTGCACCACCGAAATCCTGTCCTTGATAAACTGGACCAGGCGATTGAGAATACAAGGCCCAAAGAGTAAAATTAACAAGAGGATTATCAGGGGACCCATGATGGTGGATATCAGGGTGGTGAACCAAGGGGACTTATTAAAACAGCCCTTCAAACCACCCTTGTTGGGACTTCAAAGAGCTTTTTAAAGCTGGACGTGAAGGGGAAGCGGGCCGTGATGAGGGTGGACTTCAACGTTCCTATGAAGAACAACCAGATAACAAACAACCAAAGGATCAAGCTGCTGTCCAAGCATCAAATTCTGCTTTGGACAATGGAGCCAAGTCCGTTGTCCTTATGAGCCACCTTGGGCCGGCCTGATGGTGTCCCACACCATTCGGCTGCTGATGCACGGAAAGGAAGTAGGCAGCATCATCGGGAAGAAAGGGGAGTCGGTGAAGAGGATCCGCGAGGAGAGCGGCGCGCGGATCAACATCTCGGAGACTGATAAAGACTGGAGACAAGGTGGGAGCCAGCGAGGCCACACTGCTGAACATGCTGAACATCTCCCCCTTCTCCTTCGGGCTACTCATCCAGCAGGTGTTTGACAACGGCACATTTTCATCAACCCTGAACGTGATCGACATCACAGAGCAGGGTCGGTCTTGACAAAAAGAACCGGGCGCCCCTGCGCTGACAGCCGGAACACGGCGGCATCAGAGCAGCCGATTGTCTGTTGTGCCCAGTCATAGCCGAATAGCCTCTCCACCCAAGCGGCCGGACGAACCATGCGTGCAATCCATCTTA	17	27	795	785	-10
2S43D:07792:07633	INITIAL_QUERY	AACTGAAGCAAGTTAATAATACAGGAGCAGAGCAGAGGCCTTCTTGTTGCTTCTTCTTTGCTTTGGGGGTTTTCTTCCTCTGTCTTCGGGCACGTGGCTCCTGCTGCTCTTTTGTTTTCTTCCAGGACTTTGGCGCAGTGGTAGCTGTTTGCACTGGGGCGGGGCTCCTTCCTGAATGTAGGCTCTGGGGATCCGCAGTCTCTTCTGCTTGCCATCTGAGGAAGATTTAAAAAATTTTGACAGTACATAATTTACACAGAAGCAATGCTGTCACCTTCCCGGGTGGAGCAGGGCTGGACGGCGACCATCCTCACATGTCCGGCACATGGCCTACCAGCTCTGTCATGCCCTTAGATTTCTACACGAGAACCAGCTGACCCACAACAGACTTGAATGGAGACAAAGTTTGCTCTGTGTATATCTCTTTGG	80	90	379	389	10
2S43D:05418:05308	INITIAL_QUERY	CATTACTTCATATTCCTTACACATATCTTCTGAAAAGTTGCTGTATGGCCCTCAGGGTGAGAGTAGCTCCTTCAGTCGCTGCTCCAGTGGGAAGCGGCGCCGCTCCTCTGCCTCCCGCTTCCTCTGCTTCTCCATGTACTTGGTCTCAGAAGTTTCAGAAGCTTCATAACCTCCCTTCCCGGGCATAACTCCAGGGGTGTGTGGTCCTCTCATTCCTCTGAGGGTGCTA	266	276	171	161	-10
2S43D:01876:02683	INITIAL_QUERY	GCGGGCAGGACTGAGAGCTGAACCCGGCGGGCCAGACTTCTGCAGGGGTACCTCCCAGTCGTGGCGGGGCGGGCAAAGGCTAGCTAGAGGGCCACAGTACAGCGGCCAGCAGACGCCGACCCAGCTGGCTCAGCTCCGAGAGTGAGCCTGGGGTGAGGGGAAGAAAAAGAGGTACAACAGTGTCCTGTTCGGAGGTCTCATCGGCTCGGCCTTCTCCCTCCTGCAGTTCTTCTCCGCACCACTCACAGGAGCTGCCTCTGATTACCTGGGGAGGCGCCCAGTGATGATGTTGTCCCTGACAGGTTTTGGCCATCTCCTATGCAGTGTGGCTACCTCTCGGCTCGTCAATAGGCTCAGTCATATACACCACCTCGAAGCCCCGCTTCCGCACTCGCTCCACAAAGGCAGAGTTGGCCACTTGCTCTTTGCTCTCACCAGTGATATAGTAGATGGACTTCTGGGTCTCCTTCATGCGAGACACATAATGCCTGTGACATGGGAAAGGGGTCATTAATTTGTAATTTCTGGATTTAAACACATGATCATCAGCACGAGATGTTTTTCTTCCAGCTGTTTTCTTTTTTGGTTTTCCTGACAAGGGGGTCCTGCTTCCTAGCTCA	614	624	521	531	10
2S43D:01876:02683	INITIAL_QUERY	GCGGGCAGGACTGAGAGCTGAACCCGGCGGGCCAGACTTCTGCAGGGGTACCTCCCAGTCGTGGCGGGGCGGGCAAAGGCTAGCTAGAGGGCCACAGTACAGCGGCCAGCAGACGCCGACCCAGCTGGCTCAGCTCCGAGAGTGAGCCTGGGGTGAGGGGAAGAAAAAGAGGTACAACAGTGTCCTGTTCGGAGGTCTCATCGGCTCGGCCTTCTCCCTCCTGCAGTTCTTCTCCGCACCACTCACAGGAGCTGCCTCTGATTACCTGGGGAGGCGCCCAGTGATGATGTTGTCCCTGACAGGTTTTGGCCATCTCCTATGCAGTGTGGCTACCTCTCGGCTCGTCAATAGGCTCAGTCATATACACCACCTCGAAGCCCCGCTTCCGCACTCGCTCCACAAAGGCAGAGTTGGCCACTTGCTCTTTGCTCTCACCAGTGATATAGTAGATGGACTTCTGGGTCTCCTTCATGCGAGACACATAATGCCTGTGACATGGGAAAGGGGTCATTAATTTGTAATTTCTGGATTTAAACACATGATCATCAGCACGAGATGTTTTTCTTCCAGCTGTTTTCTTTTTTGGTTTTCCTGACAAGGGGGTCCTGCTTCCTAGCTCA	181	191	219	209	-10
2G5Z3:01878:12988	INITIAL_QUERY	CGCACACTGGCATTGCAGCAGCAACTACAGGCCGTGAGGCAGGCGCTCACGGCTAGCTTCGCCTCCCTGCCGGTGCCGGCACCGGGGTCCTGGTAGGAGTGCCCCTCCACTTAGGCCCCACTAGCCTTGGCTCAATGTCCAAGCCTCAGGCCTGGCTCTTTTCATCCTGATCTAGGCTGGTCTCAACATTCAGAAGCTGCTGGCATGCTGGCCTCCTGGTGTCAGGGGCCTCTTCTTGATTGTAGTAATATCTCCAGCCCCAAACCAGACTGTGTAAGTCACCTGCACACA	466	476	162	152	-10
2G5Z3:08824:02644	INITIAL_QUERY	CAAGTTTGTTCACCAGAGTGTAGTGGAGATCAATGAGGAAGGCACAGAGCTGCAGCAGCCTCTGCCACTCATAGAATTTTGCTGTGCCTCTTCTGTCCCAACATTCTGTGCTGACCACCCCTTCCTTTCTTCATCAGACCACATGTTGTGCCCTTAGAGCTCTCCCAAACCCTCGAGCCTGACAGTGTTGTGGAGTAGAATGGATTTCAGAAAAACCAAAACAAGA	77	87	143	133	-10
2G5Z3:05005:02557	INITIAL_QUERY	GCCTCCCCTTGCTAGGAGGCTCCTTTTCTTTACGCTGTCTCCGATTAGGTGTATTAATAAGTGTCCTGCAGTAATGTTAGCTGTAAGCCGGACTGCTAATGCCATTGGTTGAATAAATAGGCTAATTGTTTCAATAATAATAAGTATTGGAATTAGTAGAAATTGGAGTCCTTGTGGAAGGAAGTGGGCAAGTGAGCA	183	193	62	52	-10
2S43D:04706:09633	INITIAL_QUERY	TTTTTTTCAGAGCCAATTTTACATCATCTTCTGACTCAAGTTCAACAAAAGCCTCACCACTCTGCCTGCCTTCTCTAGTATAAATGAAATGAACACCTGCGACCCATCCATGAATTGTAGTAGTGGAGAGGAAGTTTGTACGTTCCTCAATTGAGCAGGACCAAGTGGCCCAGCTCCTCCCTCCTCATCTTGCCGTCCCACTGGGTGCTAGGAATCCAGGATGACGGCTGCTCTGATATGGTGCTCTTCTGAGGTGGCATAAGGCTGGCCCTTATTTGCTCTCCCTCCTCGCTGCAGAAATAATTTAATTAATTAATTACTATATTAAAGCCCTTGGTGTTTGGTCTTTATAGAGGGGGATAAGGGCAGGGTAAAAGGGCAGATCGGGACGGAGGTTGCGCAGCAAGGACCGGGCGGGAGGACGGGAGCTGTCGGTAAAGGAGGGGGTTTTGGAGAGAACAAATCGGTTTTGAACCCGACGGAGGGGGGGTCAATTAGGCAAGTGCCTCCCAGGTGACGATATATGGGACTTTGAAACATCATTCTCCATTCAGATGGTATCTATGGTTCTACATTCTTCATGGCTACTGGATTCCATGGACTCCATGTAATTATTGGATCAACATTCCTTATTGTTTGCCTACTACGACAATCTAAAATTTCACTTCACATCAAAAACATCACTTCGGATTTGAAGCCGCAGCATGATACTGACATTTGTGACGTAGTCGACTTTTCGCTACCGATACATTATATTTTACTTCTACTCACAATCTCAGAATTGCGAGTTAGCATTAATTCAAGCCTTCGACCGCTTTTCGTTTTCTTTTCTCTTTCTTTCTCTTCTTCTTCTTCTTTCTTCT	93	106	224	237	13
2G5Z3:08143:13099	INITIAL_QUERY	GGACTCCTAGGGGAGAGGATTGCTTTACGGACTCAGTGGCTCGGAAGTCTGAAGAGCAGTGGTCCTGTCCGTGGTTTGTACTCTCATAAACAGACCCTCGGCTAAGGCCTGTGATGCTTGCTTGACCACAAGGCCTCTGGATTCAGTGCTCAAGAATAGAGAAAATTCCATATTCGGAACCTGGTACACAGTGGAGCCACCAAAGGGGAGATCTCATCTACACAAGATGCCATATGGAGGAGATATCAGAGTAGGTGGTT	616	626	135	145	10
2G5Z3:00205:08207	INITIAL_QUERY	CTGAAGTTGTTTCTCATATGAAGTGGCTTCTTACATTTTTACTTTTATTCTGTTGCCTGTTGAATATATTTACTACAATGGAGTATTGTAGTTTACCAAGGCCTTTTTGGTTCGTTAATACAGTCATAGACTTCTGGAGGATGATATGGGAGTATAATGTTGTGATCATCGTGATGGCCTGTCGAGAATTTGAGATGGGAGAGGCGCCGAAAGCGAAGAAGGAAGCTCCTGCCCCTCCCCAAAGCCGAAGCCAAAGCGAAGGCCTTGAAAGCTAAGAAGGCGGTGCTGAAAGGCGTCCACAGCCACAAAAAGAAGAAGATCCGAACGTCAA	143	153	304	294	-10
2S43D:07359:12784	INITIAL_QUERY	GGCCAAGATCCAGGATAAAGAGGGCATCCCCCCTGACCAGCAGAGGCTGATCTTGCCGGCAAGCAGCTAGAAGATGGCCGCACTCTCTCTGATTACAACATCCAGAAAGAGTCGACCCTGCACCTGGTCCTCCGTCTGAGGGGTGGCTATTTAATTATTCGGTCTGCATTCCCAGTGGGCACGTGGATGGCATTACTCTGCATCTCTACAGCCTACTTCGCA	579	589	56	46	-10
2G5Z3:05469:00339	INITIAL_QUERY	GAAAAACCAACGGTGCCACCGCAGTCTTTAACACTGGTATTTTCCAATACCAACAGGCTCTAGCCAACATGCAGTTACAGCAGCATACAGCATTTCTCCCACCAGTTCCCATGGTCGCACGGTGCTACGCCAGCCACTGTGTCCGCAGCAACAACATCTGCCATCTGAAGTTCCGGAAGAGCTCCTGATGCTGAGGCTGGACTGCAGACTGGCCATGTTTCTCGATCGGAGTTCAGCCTCAATGCACCAGCTATCACAGAGCATTTTCTCATGCTGTGCCGTCGGATGGGGACAGCAGCAGGCCCATCAATCAAACAACATCTTTGAGCAATCCCAATGACCGTTTTCGATGGTCATTGCTTCTGGGTTCTGATGTCCCAGCCGAAGGAAGGGTGAGCCCTAGCAGTGTAGTTACAGCTGGATTCATGCAAGTGGGGTAAGTGATAATCAGAAGAGAAAATAATGAATCTGAAAATTAGTGACCCCCCATAGTTTAATTGCTGACATTTTTTGTTCTATTGAGTATCTAATTTGAAAAAAAAATCATATAAAGATGACAACGGCAGCATTTATAACCCTGAAGTGCTCGACATCACAGAGCAGCCCTGCACTCTCGCTTTCTGGAGGGTGTCCGCACGTGGCCAGTGTGTGTCTGCGAGATCGGGTACCAACTGTTGCCTCGGA	617	627	417	427	10
2G5Z3:05469:00339	INITIAL_QUERY	GAAAAACCAACGGTGCCACCGCAGTCTTTAACACTGGTATTTTCCAATACCAACAGGCTCTAGCCAACATGCAGTTACAGCAGCATACAGCATTTCTCCCACCAGTTCCCATGGTCGCACGGTGCTACGCCAGCCACTGTGTCCGCAGCAACAACATCTGCCATCTGAAGTTCCGGAAGAGCTCCTGATGCTGAGGCTGGACTGCAGACTGGCCATGTTTCTCGATCGGAGTTCAGCCTCAATGCACCAGCTATCACAGAGCATTTTCTCATGCTGTGCCGTCGGATGGGGACAGCAGCAGGCCCATCAATCAAACAACATCTTTGAGCAATCCCAATGACCGTTTTCGATGGTCATTGCTTCTGGGTTCTGATGTCCCAGCCGAAGGAAGGGTGAGCCCTAGCAGTGTAGTTACAGCTGGATTCATGCAAGTGGGGTAAGTGATAATCAGAAGAGAAAATAATGAATCTGAAAATTAGTGACCCCCCATAGTTTAATTGCTGACATTTTTTGTTCTATTGAGTATCTAATTTGAAAAAAAAATCATATAAAGATGACAACGGCAGCATTTATAACCCTGAAGTGCTCGACATCACAGAGCAGCCCTGCACTCTCGCTTTCTGGAGGGTGTCCGCACGTGGCCAGTGTGTGTCTGCGAGATCGGGTACCAACTGTTGCCTCGGA	94	104	595	585	-10
2S43D:08591:07078	INITIAL_QUERY	GCTCCGTGCTGTACGTCTGCTTATTCCTCTTGATCAAGAAACTGGAGCAGTTCCGGACGACCATCCACTGCAGATGCGCGGACATGGCGGCGGCTCCTCTCCCTATGGCGGCCGGAGACGGAAAGAGAGACACGAGAGGCGGGACGACA	37	47	108	98	-10
2G5Z3:08521:05110	INITIAL_QUERY	CCCCCCCTTTTTTTATTTTTTTGATTTTCTTAGACAGGGTTTCTCTGTGTACCTGGCTGTCCTGGAACTCACTTTATTTGTATTCTCATCTCACACAGATTCAGTGATCAAACACTTCTTCCTCCCAAACCCATCACATATCAGCTCATTCAGCTCACTGTTCTGGATAAGAGTGGAGGAAAATGGCGAGTGATGGTGATTCTTAGGTCTGGCTGCTACCAGAATTATCTGACTGAGAGCCTGGGTGTGGAGGCTGAACGTGACTGGTGGGGTGGCAGCTGGACCGGGGGACCATGCGTGGCATGGGAGAGGTGCTGGGCCTGGAGTTGCTGCTGCCCGATGATGGCGTTCAACTCCGTCATGGTGCCTGCTTGGCGCGTTCCACAGCCTGCGCCATCTTGCTGCTGTGCTCCTGTGACAAAAAAAGGCATATTCTGGGTCTAGGATTGTGTTCAGTCTCTTCGGCAATCTCTGTCTGCTTGTGCATTTCAATATTCAAGCCATAA	276	286	208	218	10
2G5Z3:07075:04811	INITIAL_QUERY	CCCCCCTTTTTTTTTTTATTTTTATTTATGTGCATTGTATGTTTTGCCTGCATGTCAGTCTATCTGTGTGAGCTGTCAGATTACCCTGAACTGGATTTACATCAGACTGGGCACCCTGACCCTGCTCAGGCTAAGACCAGGAAGACAGGCTCCCTGCTCATCCCTGCCTCGGGGCAGGGGCAGGGGCAGGGGCAGGCACCCTCGCCCCTCCCCCTCCGCTGCCTACTGTC	73	83	104	114	10
2G5Z3:06274:13859	INITIAL_QUERY	GAAAACACACCCATTATTTAAAATTATTAACCACTCATTCATTGACCTACCTGCCCATCCAACATTCATCATGATGAAACTTGGGTCCTTCTAGGAGTCTGCCTATAGTCCAAATCATTACAGGTCTTTTCTTAGCCATACACTACACATCAGATACAATAACAGCCTTTTCATCAGTAACACACATTTGTCGAGACCGTAAATTTACGGGTGACTAATCCGAATATATACACGCAAACGAGACAGAAGTCATAAACTATGAGTTAAGTCTGTGAAAGAGGCTCAAGTGGAGGTGATTCATTCTTTTGAAAGCCGTTAACGTGCGTAACTTGATCAACTCCCGTACTCAGAACCAC	392	404	46	58	12
2S43D:08481:14453	INITIAL_QUERY	CCCTATGAGCGACAGTGGAGAGAGAAAAGGGCTGGGGAGGAGCTGAAGGAGAGCATGCTGGATAGGAGCTCTATGCATTGCTCCAGTCAGAGTTTTGATGAGTCTTTAAATCGAGCTCAAGAGAAAGCATGAGTGCCACCCTGGTAACAGGCCCCATCAGGACCACTCTCCACGGCAAATGTAAGCAAATGACATGGGCTATATTGGCGCTCACCGGCTCTGAGCGGGTCAGTCATAGCCAGGTGAGGCCCACAGCTTCCTGAGGTCACACTGTGGGGCTGGTAGGGAGGAGGTGTAGAGGC	67	77	230	220	-10
2G5Z3:00092:07899	INITIAL_QUERY	GTCAGCTTTGCAATGAGGTCTTTATAAAAGACAAAAAGGAAGCCCACGAGGGACTCAGGTAATACAAGGAAAGATGGAAGAAAAATATCAGGGCTGCCTGAGCCCTCACCCTGAAGATGGGCTGAGATCGAGAAATTCGATAAGTCGAAGTTGAAGAAAACAGAAACGCAAGAGAAAAATCCTCTGCCTTCAAAAGAAACAATTGAACAAGAGAAGCAAGCTGGCGAATCGTAATGAGGCGAGCACTCTCAGCTGTGGTGGTGAAGCTGTAGCCACGCTCGTCAGGATCTTCATGAGGTAGTCGTGTCCAGGTTCCCGGCCGAGGCCCAGGGTCCGAGTGACGGCGAGG	10	21	201	212	11
2S43D:00073:10455	INITIAL_QUERY	GGGCGACGTGATCTCCGGCCGGTCCCACTGGTAGTCGAGCAGCGTCTCCATCAGGGCACCGTGCGTGTGGGTGGCTCTGGGCGTCGGGCCCGGCAGGTGAGCTCCGGGAGGGCA	37	47	11	21	10
2S43D:00073:10455	INITIAL_QUERY	GGGCGACGTGATCTCCGGCCGGTCCCACTGGTAGTCGAGCAGCGTCTCCATCAGGGCACCGTGCGTGTGGGTGGCTCTGGGCGTCGGGCCCGGCAGGTGAGCTCCGGGAGGGCA	168	178	51	41	-10
2S43D:06281:04609	INITIAL_QUERY	TGGCTACGTACATGGCTGGGGTGTTGAAGGTCTCAAACATGATCTGGGTCATCTTTTCACGGTTGGCCTTAGGGTTCAGGGGGGCCTCGGTGAGCAGCACAGGGTGCTCCTCAGGGGCCACACGCACCTGAATAAATTTCTTGATCTTGCCACTGGTCATTTTCTTTTCAGTATATGCCACAGTTTTGTCTTCAAACTTGTTAGCAAGATGTAATGGACGGAATATAGTGATCCCCTCTCCATTATCATTCGTACTCCTTCACCAGAGACTCAATGTTGGTGTGTGCAAATCGGTAACAGCACAGACCACACTACAGTTGGCTGCCAGGGGACCGGTACCAAATGCCCCGGCACTCTCGTGCACAAAGTCCCTGTCACTGCTCGAACCGAATCGGGTGACATTGCAGCCCTTGCGCAGCGTGCTCGACGTTTGTCACTGAAGCGGGGAAAGGGACTGGCTGCTATTGGGCGAAAGTGCCGGGGCAGGATCTCCTGTCATCTCACCTTGCTCCTGCCGAGAAAGTATCCATCATCGGCTGATGCATGCGGCGGCTGCATACGCTTGATCCGGCTACCTGCCCATTCGACCACCAAGCAAACATCGACATCGAGCGAGCTAACGGTCCCACTTCCTCCTGGGCTCCAGTGTCCAGCCAGGGCCAGGGAAGGGAGCCACAGAGTTAACGTTTTTCTAACCTTGCTACTTGGAGGGAAGGGAAGGTTGGGGGAGAGGCCTGCTTTCTATCTCCCTCTTCTACGAGCTCTCTGAGAACGACCTGAACTTCATTAAGCAGAGACAAGGATGGCTACAGGGCTTCCCGTCATCAACCTCATCGACTCTCCAGCCATGTGGACACCCGTATTCTCCCGCAGCTGGAGGTGTATGCTCTCGTCGATCGCATCGGGTACCATGGTGAGAGCCAATGGCCAGCAGAGCATGCATCTTGCTCGGTTCTGCTTGTTAATCAAA	293	354	472	533	61
2S43D:06281:04609	INITIAL_QUERY	TGGCTACGTACATGGCTGGGGTGTTGAAGGTCTCAAACATGATCTGGGTCATCTTTTCACGGTTGGCCTTAGGGTTCAGGGGGGCCTCGGTGAGCAGCACAGGGTGCTCCTCAGGGGCCACACGCACCTGAATAAATTTCTTGATCTTGCCACTGGTCATTTTCTTTTCAGTATATGCCACAGTTTTGTCTTCAAACTTGTTAGCAAGATGTAATGGACGGAATATAGTGATCCCCTCTCCATTATCATTCGTACTCCTTCACCAGAGACTCAATGTTGGTGTGTGCAAATCGGTAACAGCACAGACCACACTACAGTTGGCTGCCAGGGGACCGGTACCAAATGCCCCGGCACTCTCGTGCACAAAGTCCCTGTCACTGCTCGAACCGAATCGGGTGACATTGCAGCCCTTGCGCAGCGTGCTCGACGTTTGTCACTGAAGCGGGGAAAGGGACTGGCTGCTATTGGGCGAAAGTGCCGGGGCAGGATCTCCTGTCATCTCACCTTGCTCCTGCCGAGAAAGTATCCATCATCGGCTGATGCATGCGGCGGCTGCATACGCTTGATCCGGCTACCTGCCCATTCGACCACCAAGCAAACATCGACATCGAGCGAGCTAACGGTCCCACTTCCTCCTGGGCTCCAGTGTCCAGCCAGGGCCAGGGAAGGGAGCCACAGAGTTAACGTTTTTCTAACCTTGCTACTTGGAGGGAAGGGAAGGTTGGGGGAGAGGCCTGCTTTCTATCTCCCTCTTCTACGAGCTCTCTGAGAACGACCTGAACTTCATTAAGCAGAGACAAGGATGGCTACAGGGCTTCCCGTCATCAACCTCATCGACTCTCCAGCCATGTGGACACCCGTATTCTCCCGCAGCTGGAGGTGTATGCTCTCGTCGATCGCATCGGGTACCATGGTGAGAGCCAATGGCCAGCAGAGCATGCATCTTGCTCGGTTCTGCTTGTTAATCAAA	294	304	345	335	-10
2S43D:00046:07774	INITIAL_QUERY	CTCTTTAGTCAAGTGTCTGATGTTCCCTGTGAGCCTATGGACTCAATGTGAAGAACTGTGGAAGCCCAGTCCACCCCTCTACACCCAGGACCCTGTCCCCTGCACTGCTCTGGTCTTCCCTTCCACAGCCACTCGCCATTCCACATATTTGGCCATACTAGGGAGAGCGGCTTTTGCAATCATTTGCCAGTCGGCAGGAGTTAGTGCCATGCTGGCAAGCCTGATATCAACAAATAATGCTAATACCACACACCAAAAGGACGAAACATGAACCCTAATAAATTGTTTCCCTAATCATATTTATTGGATCAACAAATCTCCTAGGCCTTTTACCACATACATTTACACCTACTACCCCAACTATCCATAAATCTAAGTATAGCCATTCCACTATGATGCTGAGCGTAATTAACAGGCTTACCGACTCACAAACATAAAAAGCTCACTTGCCA	329	339	190	180	-10
2S43D:03587:13524	INITIAL_QUERY	GCGTTTTTTATGGACATATCGATTGTGTTTGGTCTCTGTTGAAGCATGGTGTTAGCTTGATATATGCAAGATAAAGAAAGGATTAGTCACCTTTGGATCTTGCTTATGAAGGACAGGCAACTCATGTTGTATTTAAGGACACTGATCCCACAGAAGTCTATACTTGGGGAGATAACACAAACTTCACATCTGGGCCACAGTCCGATCCTAGGGTCACGCAGGGTCACCGAGGTCAAGTAGAGTCATCCGGCGTCAACGGCAGGTCAGGGGTCATGGCAGGTCAGAGAGGTCACCGGGGTCAAGCTGGCTCAAGGCGGGTGACTGAGGTCAC	524	535	305	316	11
2S43D:03587:13524	INITIAL_QUERY	GCGTTTTTTATGGACATATCGATTGTGTTTGGTCTCTGTTGAAGCATGGTGTTAGCTTGATATATGCAAGATAAAGAAAGGATTAGTCACCTTTGGATCTTGCTTATGAAGGACAGGCAACTCATGTTGTATTTAAGGACACTGATCCCACAGAAGTCTATACTTGGGGAGATAACACAAACTTCACATCTGGGCCACAGTCCGATCCTAGGGTCACGCAGGGTCACCGAGGTCAAGTAGAGTCATCCGGCGTCAACGGCAGGTCAGGGGTCATGGCAGGTCAGAGAGGTCACCGGGGTCAAGCTGGCTCAAGGCGGGTGACTGAGGTCAC	628	638	192	182	-10
2S43D:09516:10041	INITIAL_QUERY	CGCCTGCACATTTTTGCAACTCGCGCTGCAGAATCCGCAGCTTCCTCTGGGCCTCCTGGCCCAGGTGGGGAGAGGATGCGGGCCGCCACCACCTGCTGCGCGTCCCCTCGCAGGCGGCCAGCCCCAACTGGGACTGCCACGCCAGGCAATGCTCGTGGAATGTACAGTGCATATTGGCGGCGCTCGCCTCATTACGATTCGCCAGCTTGCTTCTCTTGTTTCAATTGATTTCTTTTTGAAGGCACGAGGATTTTTTCATTCTTTGCGTTTGAGCTAAGTACTTCAGTGACATAATGAGTTTGTCCTTCACTGGGGGATGTGGGAAGTCTTTCTGTCTTAAATTCCCTTTGTTGCATTGTGCATGGTCATGATCAGGCGAGGAGAGCACGGCCCTCTGCTACCTGAACCACAGCTGATGGAAATCA	255	265	281	271	-10
2G5Z3:06558:03840	INITIAL_QUERY	GGGCCTACTGGAGAGGGAAAACTGAGGCTGTCACAGCCGAGGCCTGACCCCAGAGGACAGGGTTGTGGGATAGAAACAACTGGGTCTAGGAAGAACAGGGCCCTCCCCTCTGGGCTGGCACCCATCGTGGGGGAAATCTTCCTAGGCTTTTAGGAGATTTCACTCCTCTTTTCCTGTTCAATGGTCTCTTTGGTCGGCAGGGTGTTCTTCTCCTGCGTCTCGGTTTTCTTCAGCTTGGCCTTATCGAGCTGGCTGATTTCCCCA	8	18	174	164	-10
2G5Z3:10153:06022	INITIAL_QUERY	GAGCTGCCGCTCTTTTGGAACGATAACAAAGCCTCTTTGATCGAATAATATAAAACAGGTGACACCTAGGGTAAAGGGTACGATTACGATTCGCCAGCTTGCTTCTCTTGTTCAATTTGTTTCTTTTGAAGGCAGAGGATTTTTCTCTTGCGTTTCTGTTTTCTTCAACTTCGACTTATCGAATTTCTCGATCTCAGCA	10	20	106	96	-10
2S43D:02563:08718	INITIAL_QUERY	ATTTACGACCTGAAGAAATTTCCAGCTAAAATTGGTGCAGGTAAATATACAGAAAAGCTTCTTAGAAAATATAGGCAAAGTCTATAATGTAAATTATCTACTGCAATAATTAAAAATAAAATGCTATCATTAGAGAAAATGCTGATTCTAGGACTGGGACTGAGGGTGGCATTTATCAGCTTCTCGTCTTCCTTGCACCTCCTCCCGTTTGTGCCGGTCAGGGGCTGACCACTCGCATAATCACCATGCCATTCTTTTTATGGTAATAGCTCAGGACTGGGAGCGCCCCCATGTCGAAGGCTGCTACCTTCCGAATGCTTCGTCATCGTACGGACTTGGGCACAATGACAGTTGGGTGGGTAAGAAGGACAATGGATATTTACTGACAATTTGGAGCTAGATGAAGAAGGAACAGGCGGGTTCACGGCTAAAGCAATCGTTCAAAGAGACAGAGTGGATGAAGAGGCCTTGAATTTCTCCTATGAGGATGACTGGGTAGGTAGGGTTGGCTCCATTAACCTGATATGGTTTCACATCCTTCTTTCTGCAGGATATCTAGATGCTCCCACACGGATATCCCCAACCAAAGTCCTGGACGCCAAGCCATCGCCCAGCCCTGGACAGGCAGACAGCTACTCAGCTGCTTAAGCTTGCCCACAAGTACAGGCCAGAGACAAAGCAAGAGAAGAAGCAAAGGCTACTGGCCCGTGCTGAGAAGAAAGCTGCTGGCAGGAAGTGAAAGGGCACACATGGCAGAGCGGACAGCTCAGCCTCGTAGAAGTGGAAGCAGATGACATGATCAGTGCTGTCAAGAGCAGAAGGCTGCTTAGCATGCAAGCTAAGAGGAAGCGGGAAATCCAGGAGAGAGAAACAAAAGTGAGATTGGAACA	262	272	845	855	10
2G5Z3:05759:07840	INITIAL_QUERY	GTCCAGAACTCTTTTCCACCAATCCAAGCCACACCACCAATGGATGGCACCAACAGCTCCCTTTCGTAACACTGAAGGATACCTCCAGTCACACGAGACAACATTCCTGGCTGCACTTCAGGCTCTGTTAGACATGAGACATCTTATGATCAGAGTGAAGGTTCTTGTTCTTCAGAAGATGACGAGTGGAGAAATGACAGAAGAAGTGGTAGTGACAGCGACAGCTCAAGTGACTCTTCATCTCAGTATTCTGATTGGACAGCATGACACCGGGGGGGTTGTTGTCGATTTTCAGTCTGAGTGATCTCTGCGTTCTGGTAGGCAGTCACTGCAATGAACTGGGTCTCTTGGAAAGTAAAGACGTGTGTTGTTAGAAGCACTGCAGGCACGCCTCCTGGCGTCTACCATCCATTCATCCTCCACGATGTGCAGCCGGGGCTGGTACA	596	606	11	1	-10
2S43D:03006:13797	INITIAL_QUERY	GGACATTCAAGATATGCTCCAGGGAGAAGACTAGGAGGAGATCGCCCTGGAGCCTATTGGGAAGTAGATTTATTGAAGTAAAGCCAGCTAATATGGTAATAAATATATTTAGTTTGTATAGACACTTTTCAGGATGGGTGGCAGCCTACCCAAACAAAAAAAAAACAAGTTCGGAGATGGGGGTTCGTGGGGCAGGATTTCATCTTTAGGTTCCACGATGCTCACATGATCAGGGCAGAGGCTTCCTTGGGACCAAGTCTTACCACTTGGGTCCCAGGGCAGCATGATCTCACTTTGATGCCCAGCACACCCTGTCTGAGGAGCACAGTGG	300	310	188	198	10
2S43D:03542:02922	INITIAL_QUERY	GGCGGGTCCAGTTGAGCTTGTCCAGGCTGTCACCATCTTGAGCCCAGTCCACCACATACTCCAACGGTTTCCTGACCACAGTAAAGTAGGTAGGTTCATGGGCCTTGAGCCCAGTCTTGGCCACTCCTGGACCATACACCTTGACTTTGTTTGGATGGCTGCCAGCTCCCACATTCACCCGGAAAGGACTGTTGGGGATGCTGACACTGATCGCGGTGGATGGGTCCTTGGCCTGGGGTGAAGTGCAAGCCGGCCAGCGCCTTCACTGCCCAGCCGCACTTCAGTTGCTTACACACTACGTGTGCATCCTGCAGGTCCCACGTGTCGTCGCACACGGTACCCCA	524	534	101	91	-10
2G5Z3:01895:09209	INITIAL_QUERY	GTAGATACCGTCACTTTTCCTTTTGTAGATGTACTGCTCCATCTGAAAGTCAAGGTTGGTGCCACTAAGTGGGTCCGCAGCAAGGAATTTGAGGACATCCTCCTCCTTCATCTGCAGGACGCAAGGGCTCCGGACATTGTGTAACGTTTCCCTTTAAGTTACGATGGGAATCAAGAACAACGCCATCGGAATCCTTCAGTCCCGACTGTAGGAGGAGCCTGGTGCAAGCCACATGCTGACCTGCGCAGGCCAGATGCAGGACTGAGCAGATTTCTTTCATCTTGTAGAGTTGATGTCGGCACCCAAGGACAACAGAGTTTGAACAAGTTGCATGAAGTTATCCTGACAACCCACCAGCCAAGGGCCGTAATTAGAAATCATCAACCCTTGTTATTCCTTA	184	194	111	121	10
2S43D:09412:06272	INITIAL_QUERY	GTCGGTCTTGACAAAAAGAACCGGGCGCCCCTGCGCTGACAGCCGGAACACGGCGGCATCAGAGCAGCCGATTGTCTGTTGTGCCAGTCATAGCCGAATAGCCTCTCCACCCAAGCCGGCCGGAGAACCTGCGTGCCAATCCATCTTGATTCCAATGGCCCAGATCCCCAATTCATTGGCTGCAGGTCGAAAGGCCCGGAGCACATCCAAAACCCGTCTCTGGCTCTCTTCCTAGTCTTGTACCGTCATGACCTTTCCTTTGCTATTCTGAGGGTAGTCTTGTGACTGTA	16	26	138	128	-10
2G5Z3:08070:14463	INITIAL_QUERY	GTGGAGACTTGAGAAGTTTTATCTCTGCCATCTGAATAAAAGCAGGCATGTCATGGGTGGGAAGCGTAATAAAGGTGTCAGATTGCCTTGCTGTCATCACACAGTCAGGTCCTTCGACTTCAAGGTGCA	575	585	39	29	-10
2S43D:06564:13079	INITIAL_QUERY	TGGGGTGGGGTGGGGTGGGGAAATCTTCCTAGGCTTTTAGGAGATTTCACTCCTTCTTTTCCCTGTTCAATGGTCTCTTTGGTCGCAGGGTGTTCTTCTCCTGCGTCGTAGGAAGTACAGTGGTAGTTGGATAACTAGAAAACATTTGCCTGAGAAGACTAAGTGGCATCACTCCAGGGGACATCACGATGCAGGCACCGTTTCTGTGTCCGTGACAGGAGTGGTGGCAGTTGTGGTGTCCTCGAGGGAGCTGCTCGATAAGGAAGTTGTGCTGGATGACTGGACGGGCTGGTGTCAA	8	18	63	53	-10
2S43D:01688:03251	INITIAL_QUERY	GTTTTCTAGAGGCATGAAAGTCAATGTATATATTATGGTAGAAATAATATTGAAGGAAATTGTAATTCACTAGTGCTGCCAGAGGGATTGCTAACAAAGCACCTTTAGGAGAGATGTCTGCAGACTGAAGGGACTGTGTACTACTGTTAATGTCTAAGACCCGACTGCTCTTCCGAAGGTCCGGAGTTCAAATCCCAGCAACCACATGGTGGCTCACAACCATCCGTAATGAGATCTGACTCCCTCTTCTGGAGTGTCTGAAGACAGCTGACACAAGAGCACCCGAAAGCAAGGAGAAGAAAGAGATCTGAGGGAAACAAAGGATGGCACCCCAGCCCTGCCAAGGAGGGGAGAGGGACTGGGAGAAGAAGGAAAGACAACCATGTGGGA	269	279	126	136	10
2G5Z3:08084:06708	INITIAL_QUERY	GCTGTCTTTATATTCTACAGTAACACTTTTGCTTGTTCCTCCACGCCCCGCGACGCTACGCCGCGAGAGTAGGAGGGCCGCTGCGGTGAGCCTTGAAGCCTAGGGCGCGGGCCCGGGTCGGAGCCGCCGCAGGTGCAGATCTTGGTGGTTAGTAGCAAATATTCAAACGAGAACTTTGAAA	365	375	121	111	-10
2G5Z3:04973:13905	INITIAL_QUERY	ATGACATGCGCTCTCCACCACCCTCCAAACATACAACATGAATTGGCAACATGGGAGGAAAAAGAACCAGAATTCCCAGGCCCTACTTTTTTCTTAAAAATACTTTTAAAAGGT	141	151	58	48	-10
2G5Z3:07049:12783	INITIAL_QUERY	GCCTTCTCTCTCCGTCGGGCCTTATCAAGGGTATTGACTTTGGCCACATCGATGTCATAGAGTTTCTTGACAGCCTGTTTGATCTGATGCTTATTGCCTTGACATCCACAATGAACACAAGGAGTGTTGTTGTCCTCTATTTTCTTCATGGCTGGACTCCGTGGTCAGTGGGAATTTGATGATAGCATAGTGGTCAAGCTTGTTTCTCCAGGGGCGGCGATACCGTAAAAGCACGAGGAAGCGGTCAGCCCATTCGCCGCCAAGCTCTTCAGCAATATCACGGGTAGCCAACGCTATGTCCTGATAGCGGTCCGCCACACCCAGCCGGCCACAGTCGACTGAATCCAGAAAAGCGGCCATTTTCCACCATATAGTTCGGCAAGCAGGCATCGCCATGGTCACGACGAG	556	566	398	388	-10
2G5Z3:04492:01426	INITIAL_QUERY	GGGGTCTGTGGTGAGTGGCTGCTTCATATAGTAAAACGGACCATGTCTTAGCTCTGACTGTTCCTTATTGCTACTGTTGAGTAAGCCGGGTTTCTTTTTCTTTTTAATGGGGCTCGTGGATGAGTCTTGGGGCGAATGGCCATTGGAGGAATGTGGAGGCTGGGGAACCTCCGTTTCGGGGCCGAGTGCGGAAGAACAAAGAATCCAAAGACCCCCGCGGATGAGACTGAGACTGCCAAGGCATCACCGAGGGGAACTAGGTTGCTTACTGTGATGTAGTCCCAGGACGAGGATGGTTTCCAGGATGCTCGGCTGTGGTTCGCAGCCCAAGAGGCACAAGTAGAAGGATTCTGGACCACCCACGATGACCGGGCCCACCGGGGGGCGATGTGGCCGGGG	187	197	282	292	10
2G5Z3:02629:02908	INITIAL_QUERY	GGCACTTAGTTTTGGCAGTTGTCATTTAACTTAGTCCCCTTTTAAAGGGCGCTCCGCTCGACCCGATTGGATCCTATTAATCTTGCACCTAGGTCTGACTGGCAGGCTCAGACCTCGCCGACCGTAAGAGGAGAGGTTGTGTTCAACCGCGGCACTGGCCGCAGCGCGCACCGGACACTTTGGCTTGGTAATTCCCAGGGGGATGAAGGGCAGGAACCTGAGGCTGCTGACCCGTTGCGGCTCAGTTTCGAGGACATGGGCACTTGAAGGTAGTAGGGGATGTTGACAACATGCATAAATCTACAAATAAGCGCTCTCAACTTAATTTATGAATAAAATCTAAAATAAAAATATATACGTACACCCCTCTACCTAGAGAAGGTTATTAGGGTGGCAGAGCCAGGAAATTAGCGTAAGACTTAAAACCTTAGTTCCCTAGAGGTTCAAATCCTCTCCCTCAATAGTGTTCTTTATTAATATCCTAACACTCCTCGTCCCA	164	174	167	157	-10
2S43D:04807:10464	INITIAL_QUERY	CGCCACTCCGGATTCGGGGATCTTGAACCCGACTCCCCTTTCGATCGGCCGAGGGCAACGGAGGCCATCGCCCGTCCCTTCGGAACGGCCACTCGCCCATCTCTCCAGACCGACTGACCCATGTCAACCTGTCTGTTCACATGGAACCTTCTCCTGCATATCACATAGTTAATCCAAGTCCATGACCATTAACTGGAGCCTTTTCAGCCCTCCTTCTAACATCAGGTCTAGTAATATGATTTCACTATAATTCAATTACACTATTAACCCTTGGCCTACTCACCAATATCCTCACAATATATCAATGATGACGAGACGTAATTCGTGAAGGAACCAGTTGTCTGAGAAGCCATTGATCTCTGAGGAGACAGACCTCATTGAGCCTACCCTCCTGATGAGCTCATCTGCACATTGGTTCTTTGGCCTCTGTGTACCACAACCTCCAAATGCTTTTGTGGAAGGGAGTCATGGGATTCATCGCAAACGACTTG	619	629	470	480	10
2S43D:09037:05922	INITIAL_QUERY	CGTGGATGAGTCCTGCGCGTGACCCATCTTCCAGTTTGGGGCGCATACCTCCTTCCTTTCCCTTCCTTCCCCGTACCCTGAAGCTTCTGGAGTCTGGATGATTCAGAGCCGACACGAAGCTGTTGCCTCGGTGCCACACTCCATCATCAATGGGTACAAGCGCGTCCTGGGCATTGTCTGTGGAGACTGAGTTACACCCTTCCCACTTACTGAAAAAGGTCCAAGGCCTTTCCCTGGCTGATCCATCTGCATTTGCGGCTGCTGCCCCTGCAGCGTCGGACGAGGGCCAGCTGCAGGGCGACATAGAAGATAATTTGGGGATCATCGGGTGCCAGTTCCCGGGCTCTCTCCAGTGTCTGCAGTGCCTTGCGGTGAAGCTCATCTTGCTTGGACTTCAGGGTGGCATCAGTGGCCTGCAGGCA	561	571	17	27	10
2G5Z3:04433:05017	INITIAL_QUERY	GTAGCGGCGAGGATGTGTGATGGCTTCCTTGCCTCACATACACACATGAGATGGAGTCTGGTAGCTTCTCAACCTCCTAATGTTGCGATCTTATATTCCTCATGTTCCCCATGCTGTGGTGACCTCCAACCATCAATTGTTTTGTTGCTACTTCATAGCTGTTAATTTTGCTACTGTTATGAACTGCAATCTCCTTCACTTGGGATTTAAACCCAGTGCACTTTACCACTGAGCTGAAACCCTAAGTCTCTCTTCTCCCAGAGTCTTTTTCTGCCGAGAACAAAGCAAAGCACTCGCCCAATGACATTCTAGGCAAGTTGTCTGACCGTTTTTA	179	189	178	188	10
2S43D:03717:03483	INITIAL_QUERY	CGGGCCTCCTGTCTCTTGAAGGTTAGGTGCATCATCTCTGAATGAACAGACCTGGAAGTCCTCTACTGTATGTGTGTTGGGGGTCTCATATCAGCTGGTGTACTGTTGTCTGTTTGGTGGTCCAGTGTTTGAGAGATCTCAGGGGTCCAGATTAATTGAGATCTGCCATGGTCCTCAGGCACGATCAGCCCTTCTCCTC	175	185	37	47	10
2G5Z3:03501:08267	INITIAL_QUERY	CAAAAGGTTAAGTGACAGGAAAAGGGAGACAGGATCGAAGACAAACTAGAAAAGGCTGGTTAGAGGTAGGGAAACAGCCTTGGCCAGACAGCAAAGGAGATGGCATTCACCAATACAAGTCTAAACCTGGAACAATGATTTCCATATATTTGGTATTTAATTATATACAAGAAAAATACTTACTTGTTACAGAAGAGCTTCTTTATATAAAAGCTAGAAACACACACACAACCGGGCCTGTATGCTATCCAGAAAACCCCTCAAATTCAAGTATACTCACGCCACCCACCGGAGAATGGGAAGCCGAACATACTGAACTGCTACGTAACACAGTTCCACCCGCCTCACATTGAAATCCAAATGCTGAAGAAACGGGAAAAAAATTCCTAAAGTAGAGA	613	623	246	236	-10
2G5Z3:03760:13100	INITIAL_QUERY	CTCGTGTGTCTACATCTAATCCTACTGTGAATATGTGGTGGGCTCATACAATAAAGCCTAGAAAAGCCAATACGACAATTATTGCTCATACTATTCCTATAGCGGAGAGACTCTGGAGACTCGAGCACTGTGAAGTAATTCTGCAGTTATCAATCGTCCAACAGCATGCCAGTGCATTTTACCAGCAAGGTACTTCAAGCTTGTTAGCTTATTCATATTTTCCAGGAGTTTGTAGTCTCACTGGTGGCTGTCAGTTCCCCAGTCAAATATGTGGCCTTTTGGAGACATGTCCCGGCAGAGCTCATTGATGTTCAGCTTCGGCAGGCTCCTTTGCTTCCTCGCTGTCTCCAGCCGCAGCATCATCTCGAGGTGGCTGCTCCTCCCTCGCGCGCCGGGCGCCCTCCGCAGCCGCCGCCAAC	133	143	391	381	-10
2G5Z3:06603:04299	INITIAL_QUERY	GTATCATCAAGGCCTTCCGCAACATCCCTGGTATTACTCTGCTTAATGTAAGCAAGCTGAACATTTTGAAACTGGCTCCTGGTGGGCATGTGGGCCGTTTCTGCATCTGGACGGAGAGTGCTTTCCGGAAGTTGGATGAGCTGTATGGCACTTGGCGGAAGGCTGCTTCCCTCAAGAGTAACTATAACCTGCCCATGCACAAGATGATGAACACCA	394	404	186	196	10
2S43D:00820:02561	INITIAL_QUERY	GTGGTCCTTGGCCAGTTTCTGGTGCTAAAGAAAGATGAAGACCTCTTCCGAGAATGGCTGAAGGATACATGTGGTGCCAATGCCAAGCAGTCCGGACTGCTTGGGTGCCTCGAGAATGGTGTGGTGAATTACTGATAAGTATAAGGCAGAAAGACTACTTATAATGCCTTGCTGCTCTGCCGTCATGGATAAAACTTTTAAAAAGTAATTTTCTACAAAGACACTCGGGACACGCGCACTCCACGAGGAGCTGGTGGTGTCTGAAGAAGAATCGGAGACGGGGGAAAGGATGGACTCGGGCACTGGGACCAGAGCAGTTGCTGAGAGCCTGTGAAGCTATCACTGTGGGGGAAAGTGGACTTGAGCAGCTGGCGCGAGAAGATTGCTAGGGACGTGGCTGACTAGGAGGCTGCTGACCTCCAACAGGAATTTCACCACTTAACCCTCTAGAAGTCCCACTACTTAATACTTCAGTACTTCTAGCATCAGGTGTTTCAATTACATGAGCTCATCATAGCCTTATAGAAGGTAAACGAAACCACATAAATCAAGCA	499	509	368	358	-10
2G5Z3:03881:02656	INITIAL_QUERY	CTGCCTTCAGGGACACTTTCACTTGGAAAATTACAACACTAGGAACAAGTCAAGGCTCACACATCTACCATTTGCTTGTTGAAAGCAGCTCATACTAGCAAATAAAATTAAATCACTGTACTTACTTTTTCCAGTGGGAGAGAAACCAGAGGACATGCACAGGAAGTCAGAAGGACACTTCACCTAGCCATGTCTGGAGCCAGAAGCTTCCATGGCCTGTACTAAAGAAGCAATGTGTACTGTGCCAGCCACAAATGCATTATACTAACTTATGTTCACTTTCTTTTCTGTCAATTCCTTGATCCTCACATTATTGATGTGTTTTGCATGTCGCATGGATTCCTCTAGGTTTGTACAGTGGGGCGCAGCACTCCAGGTGGCCACGTGACAGAGCAGAGGGCGGAGCCTTCAATCCCACTACTGCGGAGGCCAAGGCAGGAGGATCTGAGTTTGAATTTGAGGTCAGCTTGGGCTACCTATCAATAAAAGTGATCCAGCGGGGCCGGCAGAGCAAAGGCCTGACCCAGAAGGACCTGGCCACGAAAAATCAATGAGAAGCCGCAAGTCATCGCAGACTATGAAAGTGGACGGGCCATTCCGAATAACCAGGTTTTGGGCAAAATTGAGAGAGCCATCGGCCTCAAGCTCCGGGGGGAAGGACATCGGGGA	214	224	533	543	10
2S43D:08928:01560	INITIAL_QUERY	CTCACTTTGCTGGCCTCTGCCTCAGCTGCTGGGATTAAAGGCACAGGTCACCACTGGCTTTGACTTTAACTGTTCTATTCTTTATTTTTAGGTATGCTCCCAACTAAGTCACTAATATTTTAATTAGAAAGTATTGGCATGGGTATGAAATGTCCACAAGTTTGAAAACAAAACAAAACAAAACAAAAATCACAGTTGCTCTTGGGGACTCGCTGGTAGCCACCGACCACGGTCTCAGCAGGATGTGGCTGTGGCCACGGGGCTCCGTGGAGCTCTGGGAGCTGTGGAGGTGGGTGGCGACCAGGTGGAGCCAGCACGTGAGGTATGGTGCCAGATCTTCTCCATGTCGTCCCAGTTGGTAACAATGCCATGTTCAATGGGGTACTTCAGGGTCAGGATACCTCTCTTGCTCTGGCCTCGTCACCC	8	18	370	360	-10
2S43D:07918:02143	INITIAL_QUERY	TGAAGGTGCCTTCCAAACAGAGTTGGGTGACCATTCCCCGGGAACAGTTCACCATGGCTGACAAACTCCTCATCTGGGGGACACAAAAGGGACGGCCTCTGTGGTCCTCTGTCTCTGTGAACCTGGAGACCCAAATGAAGCCAGACACATTCCATTTTCAACAAGTTCTTCAAAAGAGATTGTTCATAAAGTTTAAAATTTTAGAAAGATATTTAGAACAAGTTCAGTCGTGTAGCATATGTAAGGTCCATACCGTGCCCATCCTTCAGTGGGCAGGGGCAACTCCACAGTGGCACTGTGCTTCCTACTGACTCAGTAGTGCTTAGCTCCCAAGACCCGCTCCTCAGTCTTGTTCCAGTGGGTCTTTGAGTTGCGGTATAAGGACGGAAACATGATGGGCAGAATCTTCGCTGCGTTGTCACTGATTAAACTCATGATGTACTCGTTGTTCCAGTAATAGAGCGCCCGCTCGGCCACCTGGAAGTGAGGGCTGGAAACACATTTGGCTAACTGTCGA	252	264	413	425	12
2S43D:07885:10933	INITIAL_QUERY	GTTCGGAGCAGGTACACTGACTACAAAGTCATCAGTCACCATGGGACAGCCAATGAGGTCCAGAGAGCAAATGAAGGGCTTGAAGGTCTCGGGTCCAGGTCCTTCTTGGTTGAGCAGCAATGGGTATTGAAAAATATAAAACACTGAACAGAAATGACTAAAAGGAAATGGGTCTTGAAGTTGATTGGAGACCTGAGCGTTTTCATCTTGAGACATTGATGATGGAGTGTGGCACCGAGGCAACAGTTGGGTACCCGATCTGACAGACGACACACTGGCCACGATTGGCGGACACCCTCCAGAAAGCGAGAGTGCAGGGCCTGACGTCGTAGTGACTGTCGAGCACTTCAGGGTCCTCGCAGCCAGCACCCATAGAGGCAAGCACACCTCAAGCCAA	214	224	274	284	10
2G5Z3:03381:08208	INITIAL_QUERY	GGGAACTTGCCAGCCTTGTTTAGGCCTGGGCCCAGGATACGTGGGATCTGCTTAATCAGAGACTCAGAGGCCAAAAAGGCATCGTACTTCTTAGCCAGCTTCTTGACCAACTTCTTGTTTTTGTTAAGCTTCTTGAGCGCCTCGATGTCCATGTGGGACCTTGTCTATGGAAAAGATAGGTTTCTGACACATATCATGGCATACCATGCTTACAAACCTATGTGACCCGTGACAATTTTTGAGAAGAAAACAATATTCAACTTTTCTAGACCCCTCCAGTTCAGTTCACCAGGTTTTAGGTCGTTTTGTTGGGATTATATATGAATCAAAGCATAGGTCTTCATAGTCAGTATATTCGTAGCTTCAGTATCATTGGTGCCCTATGGTTTTAACGGTTAATACGGGATTCCTCCACATCACGAGGGGGTCTTGGAGATGATGGGGCGGGGTGGGGTGGGGTGGGGAAATCTTCCTAGGCTTTTAGGAGATTTCACTCCTCTTTTCCTGTTCAATGGTCTCTTTGGTCGGCAGGGTGTTCTTCTCCTGCGTCTCGGTTTTCA	8	18	505	495	-10
2G5Z3:09787:13673	INITIAL_QUERY	CCTGTACCAACATCATCTTCTCTCAGTTCCTCAGGTCGGCTGACTATCCGTGCCCCACAGGCTCTAGCAATGCGATTATTGTCTGTTTTCCGGACTCTACGAATGGCTGTGACATTGGCCCGCATGAGGTAGTGCTGAGCTAAATCTGAGATCGCCTCTCTGTGATGCCACGTCCAGGCTTCGAGCTGGATGATGTCCTCACAC	83	93	77	67	-10
2S43D:08591:13321	INITIAL_QUERY	TTTCCAGTGAAATAGCGCTGCCTTCTCAGTCATCTCATACCTTTCTGTGTGACCCAAACTGAGTGCCGCTGTTTCCCAACTTAGAACAATGCCCATAGCTCATATGATAAGTGTCTCCACCTGTTCCTTGGCTCCTTCAAATGAGATTTCCAAGGAAACCAAATAAAACGTCAAATAAATTTGAATAGGAGTCCAGCCAAGGGCCCAGCCAGAGCAGAACCTGGGCTGGGGGAGGGGCCTCTGTAGCTCATGGATCACTGCTGCCACCACCGCCACCCTGGAAGCCGGTTATTTTGCCATGGCCTTGATTGCAACAGCAGGCCAGCACGGATTCCCCCTGGTATCCCTCCAGGAGTGCCAGCAGAAGAGCGCCCGCTGCGCCCAGCCGGCCCCACCATTACTCCGCCCCAGCCGTCGAAATAAAGCAGCAACATGAAAGCACACAGACCAGAGCTCTGGGGTCGAAATAAAGCAGCAACATGAAAGCACACAGAGCTCTGGGGTCGAAACTCATACACCTTTGCACAGGGTAGAGG	449	460	278	289	11
2S43D:08591:13321	INITIAL_QUERY	TTTCCAGTGAAATAGCGCTGCCTTCTCAGTCATCTCATACCTTTCTGTGTGACCCAAACTGAGTGCCGCTGTTTCCCAACTTAGAACAATGCCCATAGCTCATATGATAAGTGTCTCCACCTGTTCCTTGGCTCCTTCAAATGAGATTTCCAAGGAAACCAAATAAAACGTCAAATAAATTTGAATAGGAGTCCAGCCAAGGGCCCAGCCAGAGCAGAACCTGGGCTGGGGGAGGGGCCTCTGTAGCTCATGGATCACTGCTGCCACCACCGCCACCCTGGAAGCCGGTTATTTTGCCATGGCCTTGATTGCAACAGCAGGCCAGCACGGATTCCCCCTGGTATCCCTCCAGGAGTGCCAGCAGAAGAGCGCCCGCTGCGCCCAGCCGGCCCCACCATTACTCCGCCCCAGCCGTCGAAATAAAGCAGCAACATGAAAGCACACAGACCAGAGCTCTGGGGTCGAAATAAAGCAGCAACATGAAAGCACACAGAGCTCTGGGGTCGAAACTCATACACCTTTGCACAGGGTAGAGG	634	644	381	371	-10
2S43D:02405:08262	INITIAL_QUERY	GCGCTTAAATGTATCCCGATGCAACGGACAGGTTCAACTTCTGCGTCTTAAGAATTGTCCTTTCAATTTTTATACCGTCAATTATCTCGTTTGTTATACAGGATTTCAAGGTCTTTCTTCACTTCTTGACACAGTTAACACTTGGATTTACATGATCTTTTTTGTGTTTTGCTTTTTTTTAAAAAATAAAAGTGCTTTGTTAATTTTTGGTTAATTTTCCTTCCCCAATTAATTTTACCTTGGGAAGTTAAAATTTTATTCCTTAACCTTTTGGAATTGGTTTTTTAATTTAAGGGTTCCGTTGGGGAAAATTCCAACCCCGGAACCTTGGCCCCCCAATTAAGGAAGGAAGGGGCCTTGGAAGGAACCTTTGGGAAAAGGCCGCATGATCTTTCTGGCTCCACTCAGTGTCTAAGATACCCGCTCCCCTGCTTGCCTCCCACAGCCTCCCCTCATCCTCTCTCAGCCCAGCCTCGCCTCAGTTCGAGTCTTGTTGTTTCATTC	578	588	427	437	10
2G5Z3:06006:00817	INITIAL_QUERY	CAGGGTTTCTCCATGAAGTCCTGAAAACTCTCTTCTGTAGTATAGTCCTTGAACTCACAGAGCTCTGCCTGCCTCTGCCTGCCGAGATGCATGGGATTAAAGGCGTGCACCACTACTGCCCA	331	341	77	87	10
2G5Z3:04341:00882	INITIAL_QUERY	GCCGGTCTTGTCGATCAGGATGATCTGGACGAAGAGCATCAGGGGCTCGCGCCAGCCGAACTGTTCGCCAGGCTCAAGCGCGCATGCCCGACGGCGATGATCTCGTCGTGACCCATGGCGATGCCTGCTTGCCGAATATCATGGTGGAAATGGCCGCTTTTCTGGATTCATCGACTGTGGCCGGCTGGGTGTGGCGGACCGCTATCAGGACATAGCGTTGGCTACCCGTGATATTGCTGACAGGGAAAACCTTCACTAACTAGAAAATATCCTGCACAGAGTCCCAGTGCTCTGCGATTCATCGTGAGGTTGATAGGTTTTAGAGGTTACGTGAATCAGCTTGGAATTTTTTATTCTTATTGATGCAGTCGTCGTCCTCCTCCTCCTCGTCGTCTCTC	454	532	0	78	78
2G5Z3:04533:10475	INITIAL_QUERY	GCATCGGCCATCCTCCTGACTTTTGAAACAGCTGTCATTATGAATCCAGAACAAGGGGACCTCAAGAACATGTGAAGGGTACCGCCGAGGCGGGCCCAACGGGCGCAACCACAAGAAGGCACCTTC	615	625	41	31	-10
2S43D:03329:07227	INITIAL_QUERY	CTTCAGCTCCAGCTCAGGCTCCCAAAGGTGCTCAGGCCCCCAAAGGTGCCAGGCCCCTGTGAAGGCCCCCATAGAAAAGGCTCCTGCCAAGGTCGTGAAGACAGACGGAAGCTGCTGTGACACACCTCCCACTTCCGTCGGGCCAGGGTGTTTTTTCCGGCAACGAGCCCGGGAATGGACAGTCACAGGCTTGCGGATGATCAGCCCATCCTTGATCAGCTTCCTGATCTGCTGACGGGAGTTGGCATTGGCGATTTCATTTGGTCTCATTGGGATCCAACCAGACAAAGGCAAAGAGCTGATACTTTCCAGGACCATCCCGGACTTTAGGTCCCACTGGCACAGACTCGGAGATGGACTCAGCCGCTGAGCGTCCCTCCTGAGATGTCCATACGCAGCTTCTGCGTCCAGAAGCGAAACTGATTAGAGTTTCGTCCAGAGAAGTGTCCTACTCCATTCCGAACTCAGAAATCCACCTGCCTCTGCCTCCCCAAGTGCTGGGTTTAAAGGCGTGCGCCACCACCACCCGGCTGGCAAGAGGATGTTAAGTTGGAGGCCAGCTTGGAACATACAGTAAAAAACTATCTCA	477	487	430	420	-10
2G5Z3:03012:09228	INITIAL_QUERY	CTGGAGGAGTACTTGAGCTCCACTCCGCAGCGGCTGAAGTTGCTGGACGCTATCTCCTTATATACTGCTGACCGGGCGCTGCAGTTCGGCTACTGTCTCCTCGTGGGCACTCCCTTACTTCAGTCAGCACACTGCCATGCAAAGCATCCAGCACTCCGTCCACTTCTGTGACCCTGGCAATGAGTGCTTGCCTGTGCTGGTCCACAAAGTGTCCTGTTCTGGCTGTACTCTGAGCAGGGACACTA	507	517	81	71	-10
2S43D:08890:04655	INITIAL_QUERY	CCCCTTTCCCTTTCTCTTTTTCCTTTTCCTTTTCCTTTTCCTTTTCCTTTTTTCCTTTCCTTTCCTTTCTTCTTCCTTCCTACCTCACCCTTGTTCTCCGCAGATACCAGCCCGCCCTGTCTTGCTCTGCCCATTCTCTCAGAGCCATCACCCAAACAGGCCAACCATCTACCT	396	406	126	136	10
2G5Z3:05255:12871	INITIAL_QUERY	CAAAATTCTGTGACAGATTTTTGGTCAAGTTGTTTCCATTAAAAAGTACTGATTTTGAAAACTAATAACTAACTAGCACACACAAAAATGCCAACACAACTTCTTCCATCCACGTGGTACCCGGTGGTGACCTGGCCAGGTGCAGAGCAGGCTGTGGTCTTTGACTACGCTGAACTGATGGGCCTCAAGCAGGTTTATTACCATGTGCTGGGACTGGGCGAGCCCCTGTCCCTGAAGTCTCCTCGGGCTCTGAGACTCTTTTCCCAA	493	503	218	208	-10
2S43D:00397:03947	INITIAL_QUERY	CTCGAGCCAGGGTGTCACACACGCTGTCCTTAAATCTGCATCTGCTCCAGGTATTTGTAGGTTGGTTTTCATAACCATGGCTGCATCTTGTTCAGGCTTGACGGCTCTTCTGGGGTGAGCATTGGGGTCAACCTCCACAATCCCGTGGCTGATGATCAGCTTACATGAATACAGCATCTTGATCTCCGCCATCGACGTATGGGGAACGAGATGTGCGTTTGATATGGGTCA	12	22	84	74	-10
2S43D:06692:01997	INITIAL_QUERY	AGATGCTGAAGCTCCTGGACTTTGGCAGTCTCTCTACTCAGGTCACTCACCTACAGTTCGGCATAATTTGAAAACACCGAGGTAAGCATAGTTTATTGATTTTAAACTGCAAATAGTCGTTACAAAAAGTTTTTTTTTCTTTTAAATAAATTCACACAAAGAAAGAGAAATAGAAAGTCGACGGTAGTGACCAGCAAGAAGGAATAAATAATTACATTCATCTTTATGTGTGAATGGGTCTGGATGACTTTATAGAAAATAGGCGTACTGGCGTGCTGTGTTTTTATACTGGCTGAAGACATCATGGATGGCTTGTGTTGACTGAAGACAGCGATACTTCCTCTTCTTCGAAGTAGAGGAGGGGGTGTCATATTCACTGGGGGAGGGTCTGAAATGTATTGGGCTGCCAGAAAAGAGTTGGGGCGTGGCTGCGCACGCAGATAAAGGCCAGATGCCAAT	508	518	52	42	-10
2S43D:04256:11597	INITIAL_QUERY	ACAGGAGTTGATTCAAGGAGACCCACTTGGCATGGCTGGAAGACTCTTCTAGTTGCTCAGACCATACCGAAACTGGAAGAGACAGTGATGATTGCTGGAGATTCAGACATGAAGAGCATTCCAGATCGGATTATGTGCAGGGAGCAAGGTGAGATGACAGGAGATCCTGCCCCGGCACTTCGCCCAATAGCCAGCCAGTCCCTTCCCGCTTCAG	260	270	204	194	-10
2G5Z3:07223:07623	INITIAL_QUERY	CCCCGCGGCCTCCACTGAAGCCACCACCACCATCGCTGTGGCTGGATGCTGGAAGAGTCCTCCCTGTTTGTGGACTCAGGATGACAGACGCAGCCAGTCCGAACTTGTATTCCCCCAAAGTGAAATTCTTGTTTTCTGCATGGTACCTATAAATGACGCTTTCGCCAGCTGCACATCTTCCAGGGACTCGGCAGCAGGTACAGCAGGCGTTTTCAACTCTTCCCTTTCAAAGATGAGTTTGTTTCTTGGGTTCAATTCTCCTTCCAAAGTTTTCTTGAAATTACACCGGAACTGACAGATGAGAACTTTCTGCGGTGGCCACACGGGCGGCGCCCACTGCACAGTGGCCTCCAGGGTTGCTTCCTCAGAAATATCCACTTGAGAGAAGATCTGGGGTGTGTCTGGCTTCATTTGGGTCTCCAGGTTCACACGCCGACTGACCCATGTTCAACTGCTGTTCACATGGAACCCTTCTCCACTTCGGCCTTCAAAGTTCTCGTTTGAATATTTGCTACTACCACCAAGATCTGCACCTGCGGCGGCTCCACCCGGGCACCTCTGTGGTCCTCTGTCTCTGTGAACCTGGAGACCCAAATGAAGCCAGACACACCCCAGATCTTCTCTCAAGTGGATATTTCTGAGGAAGCAACCCTGGAGGCACTGTGCAGTGGGCGCCGCCCGTGTGGCCACCGCAGAAAGTTCTCATCTGTCAGTTCCGGAAAGAACGTGTCGGTCAAAGATGTTAGACGAGGCAATGTTGCTGGTGACAGCAAAAACGACCCACCAATGGAAGCAGCTGGCTTCACTGCTCAGGTGATTATCCTGAACCATCCAGCCA	365	375	534	544	10
2G5Z3:07223:07623	INITIAL_QUERY	CCCCGCGGCCTCCACTGAAGCCACCACCACCATCGCTGTGGCTGGATGCTGGAAGAGTCCTCCCTGTTTGTGGACTCAGGATGACAGACGCAGCCAGTCCGAACTTGTATTCCCCCAAAGTGAAATTCTTGTTTTCTGCATGGTACCTATAAATGACGCTTTCGCCAGCTGCACATCTTCCAGGGACTCGGCAGCAGGTACAGCAGGCGTTTTCAACTCTTCCCTTTCAAAGATGAGTTTGTTTCTTGGGTTCAATTCTCCTTCCAAAGTTTTCTTGAAATTACACCGGAACTGACAGATGAGAACTTTCTGCGGTGGCCACACGGGCGGCGCCCACTGCACAGTGGCCTCCAGGGTTGCTTCCTCAGAAATATCCACTTGAGAGAAGATCTGGGGTGTGTCTGGCTTCATTTGGGTCTCCAGGTTCACACGCCGACTGACCCATGTTCAACTGCTGTTCACATGGAACCCTTCTCCACTTCGGCCTTCAAAGTTCTCGTTTGAATATTTGCTACTACCACCAAGATCTGCACCTGCGGCGGCTCCACCCGGGCACCTCTGTGGTCCTCTGTCTCTGTGAACCTGGAGACCCAAATGAAGCCAGACACACCCCAGATCTTCTCTCAAGTGGATATTTCTGAGGAAGCAACCCTGGAGGCACTGTGCAGTGGGCGCCGCCCGTGTGGCCACCGCAGAAAGTTCTCATCTGTCAGTTCCGGAAAGAACGTGTCGGTCAAAGATGTTAGACGAGGCAATGTTGCTGGTGACAGCAAAAACGACCCACCAATGGAAGCAGCTGGCTTCACTGCTCAGGTGATTATCCTGAACCATCCAGCCA	273	283	90	80	-10
2S43D:01820:03245	INITIAL_QUERY	CCCCCCTTTTTTTTTTTTTTTTTTTAATAAGATAATAGTTGAAAGTTATTATGGTTATCAATATTATATCTCAGTAAGAGTAAAACAAAACAGAAGAGCTGAGACTGCCAAGGCACACAGGGGATAGGCCACGTGCTTAATGGCCACCGGCAAGTTGTCGGCGACGCGGATGCCAGAGTAGACCGAGCCGAAGCCACCGCTGCCCAACAGCGGGCCCACCTGGTACTGCGACTCCAGGGCAGGCCACCAGCCCTACATTTGCAGATGAGGCTCCCAATGTTACATTGGCCAGAGCTTGGCGAGATCTAGGTCTGGTTCTATAATAGGATCGAGGTATTTCCAATCCCGCTCAAGGTCGAGATCAAGATCCAGGTCTATTTCACGACCAAGAAGCAGCCGATCAAAATCCAGATCTCCATCTCCTAAAAAGAACGTCGTTCCCCAATCAGGAAGTCCACACAGAAGTGCAAGTCCAGAAAGAACGGACACGCAGTCAAATTTGAAAGTTTTGAGGATGCAGCACTGGAGAAAATGGCTTGGCTGTGATAGGTGTATTTTTAAAGCTTGGTAAACATCATAAAGAACTACAGAAAATTGGTGGACACTTTTGCCATCAACTTAAGCACAATGGAACACCCTGGTGGTTTTTAAGGACTGAGCATGATTTGACATTGGTTCCATTCTACCAAGATGATCTTTCCCTTCATCTCTTCCAGTGGTACAGCTTTTAGGATTTCCCAGGCAGCCCTCTCCCCACCTCACCTC	91	101	391	381	-10
2S43D:08782:12110	INITIAL_QUERY	CCCTTCTCTTTGGCTTCCTTTTTCTTCTGGTCATTCTCCTTCACCCGCTTCAGGAAGCTGTCTCTGCTCTTTGAGTGCTTGATGTGCTCAATCCGCACATTGATCCTCTTGGCCAGAATTTTGCCCTTAACCTGCTTGTTGACCAATGATGCCCACGGCATGCTGGGTGACATTGTAGA	260	270	43	33	-10
2S43D:02776:13386	INITIAL_QUERY	GCACCTGCAAGCTCCTGTGAAGCAAGGTCAAGTGGGGCGGAGCCAGGCTAGGCTCATGAGCAGAGATGCTCGCCAGCAAATCCAACTCTGTGAGTTCAGTCCCTGGGACTCACATGGTGGGGAGAAAAGAAAAGAGCCCTGCTCTTCGTTCTCGCTCAGCCTCCACACTGTAGA	482	492	139	129	-10
2S43D:00536:03927	INITIAL_QUERY	CATACATCCCCCATTGATGTGATCATCTTGGCCAGCGACGGCTACTACGCCATGGTGGGACAGGTTCACGGGGGCCTTATGGGTGAGTGGTTTAGTCCAGGCACTTCTTTACTGTTCTAAAACAATAGTATAGATTTGGATATGAAGCAAGATTGTAGTCAACTGGTAGAAAGAATAAATGTCTTCAAAACAGCCTTTAGTGAAAGTGAAGATGGATGAGAGCAGACCAGCAGTTGACATTTAATTCGAAAATTAATAGCTGTACTAGAATCAATTGAAATATGCTGTCCAAGCCAAGTATGGAGATTATAATAAAGAGATTCACAAACCAGGCTATCTGGCTAATGACAGACTCTTACCACAGCGTGTTTTGGAACAACACAAAACTGACCAAAGAGCAGTGGGAGGAGAGAATACAGAACATGGCGATGAGGTGCAAATCGGTAGTTATCTCTCAAGTTGCTGGCTGCTTTTAGGAATTCAGAGTGCCCATCACTGAATAAATCCCATGAAAAAACCCACCACTACGAGGCATCTTTATCACTAATGTAACTTCTTAAATTCTTCCTCAGTCCTGAGAGGAACTGAAGCTGGAGTGCCAGCTTTATATACAAAAAAGCTCTTTTGCCAGGTG	568	578	421	431	10
2S43D:09124:06919	INITIAL_QUERY	CCCCCCCTTTTTTTTCATTTTTATTAGGTATTTCGCTCATTTACATTTGCAATGCTATACCAAAAGTCCCCATAGCCACCACTCCAAGCACACCCTCTGCCTGGACAAGCAGGCTTCATACTTCTACCCTCAGGGAATCCCCCTGCTTCTTATTTCGACTCAAGGCTCTTCCTAGAGAGACCCAAGACCAGTCCAACCCGCCATGCCCCGAGAGTCACCGCCAGCCATCAGACCAGACTGACTAACAATAGGATGGGAATAATCTTTTCTGGATGGATGGATGGAACAAAATCAATAAGAACAAAGAAATTGGAATATTTTCCAGAAATAAAAGATTTCTGTATGATTCCTATTACCAAGGACTGTGTTCAAAAGGAAAACTGAGA	612	623	263	274	11
2S43D:01255:04333	INITIAL_QUERY	GGGAGTTGCTGTTGAAGTCGCAGGAGACAACCTGGTCCTCAGTGTAGCCCAAGATGCCCTTCAGTGGCCCTCAGATGCCTGCTTCACCACCTTCTTGATGTCATCATACTTCGG	574	585	73	84	11
2S43D:02672:01913	INITIAL_QUERY	GTGATGGACAAGTCCAAAGGTGTGCCTGTCATCAGTGTGAAAACATCTGGGTCTAAAGAGAGAGCCTCCAAAAGTCAGGACCGGAAGTCAGCCAGCCGGGAGAAGCGGTCTGTTGTGTCCATTTGACAAAGTTAAAGAGTCTACGAAAGTCCAGAGACTCAGAGTCGTCGGAGGGAACGGGAGCGCAGTGGAGCGGGAGCAGGACGGCGCTAGGCGAGG	80	90	107	97	-10
2G5Z3:07758:04715	INITIAL_QUERY	TCAGCATTTGGATTAACAGATGACCAGGTTTCAGGCCCACCCAGTGCCCCTACAGAAGACCGCTCCGGACACCTGACAGCATTGCTTCTTCCTCCTCAGCAGCACACTGTGACCATCACGACGGGATCCACCCGGCACTTGGAGACTTCGGCTGGTATACTTTCTTCTTTGGGTTCGGGGTCAGAGTTGATTTCCTTTCATGACTGGCAGACTCGCTGGCATTTTTACCTGGGACCAGGAGGCCCAGATATATGAGCTGGTGGCACAGACATCTTCGGAACGCAAAAACTGGTGTAACCTCATCACTGAGACTGCCAAGCACCACAGGGGACTGGCCTCTCCTCCTCGTTCAACACCTTTGTGTTAGAATGTCCGCACCTGAGTGACAATTGTTCTTCATTAGCACTGTTGAAGCGTTTTCACCATCTAACAGCGCACTGGACGCTGTGGC	293	303	130	120	-10
2G5Z3:07563:11609	INITIAL_QUERY	GCTGCGTTTGCCACTGATGTTGTGAAGACGTTATCTGCAGAGGACCCCACGTTGGCCACAGTCACTGTGGTCACTTCTTTCTCCCTTTGCAAAGAAGCTGCAAGTCCCATAGGTCTAGGACACCTCCTTGTCGATCAAGACATGGCAGACTCCAGACTGAAAGCCGCCTACATGAACAAAGAGAGAAGCAGCCCAGATCGTAGGAGAAGGACGCCATGAAGTATGAGCAGATGAAACGTGATGCGGAGATAAGAAAGGATCAATGATGGACGGAGCACGATAGGCGTGCGTGAA	460	471	126	137	11
2G5Z3:07563:11609	INITIAL_QUERY	GCTGCGTTTGCCACTGATGTTGTGAAGACGTTATCTGCAGAGGACCCCACGTTGGCCACAGTCACTGTGGTCACTTCTTTCTCCCTTTGCAAAGAAGCTGCAAGTCCCATAGGTCTAGGACACCTCCTTGTCGATCAAGACATGGCAGACTCCAGACTGAAAGCCGCCTACATGAACAAAGAGAGAAGCAGCCCAGATCGTAGGAGAAGGACGCCATGAAGTATGAGCAGATGAAACGTGATGCGGAGATAAGAAAGGATCAATGATGGACGGAGCACGATAGGCGTGCGTGAA	628	638	53	43	-10
2G5Z3:07823:12925	INITIAL_QUERY	TGACGCATATGATCATCGACTGCTCCACTAAAGA	623	633	12	22	10
2G5Z3:09943:07600	INITIAL_QUERY	CTTCTCTGTACTCTCAGCCATAGCAAGCGCCCGTCCCAGGGCTGCTTTCACTTCATTCACTAGGGCCACTTGAGCATCTGTGCCACTCCCCGCAGCAGCCAGACTTGCAAGGAATAGACGTGCCAGGGCAGTGTATCCTTGTCTTCTTGCCCATTTTCCTATTGAGCTGTTCATAACCTGCAGGAGTAGCTTGATGCTCTTGGACCAGCCTGAGCGGACTGCTAATGTCATTGGGTTGAATAATAGGCTAATTGTTTCAATAATGGACAGATGAGGTCAGTACTGGGAACGCCGCAGGTGAGAGGCCATTTCATAACATTTCTTGTTGATCAAACCACCGTGGACACCTTCTTTGCCCATCAGCAGGACTAGCGTCTTGGCAGTCATGGTGACAGTGACATTGAAGGTGGGAGGCAGCTTGGGTCCTGAGCAGCCCAGAAGGCTTTGGTAGTGGCAGGCACAGTCTCTGGGCTGGGGTCTGCATTAAATACACAGGGCTTTTTTAGTGCTCGTCTCGAGCTCTGAAGGCAAGAACTTGTACTGCTGCTGCCGGATCTGGGCGAGA	485	495	191	181	-10
2S43D:08957:08747	INITIAL_QUERY	GAGCAAGGCAAAGTTTGAGAATCTCTGCAAGCTCATGAAGGAGATCTTGGACAAGAAGGTTGAAAAGGTGACAATCTCCAATAGGCTTGTGTCTTCACCCTGCTGCATTGTGACGACGGGGTCAAGCTGGCTCAAGGCGGGTGACTGAGGTCACGTGGGGTCATCTAGGGTCAGCACGA	524	535	128	139	11
2S43D:03585:05850	INITIAL_QUERY	AGGCCACTGTGCAGTGGCGCCGCCCGTGTGGCCACCGCAGAAAGTTCTCATCTGTCAGTTCCGGTACAAGGAATGCCAGGCTGAAACATGGACACCCTGCGCTGACAGCCGGAACACGGCGGCATCAGAGCAGCCGATTGTCTGTTGTGCCCAGTCATAGCCGAATAGCCTAC	58	68	161	151	-10
2S43D:00397:10886	INITIAL_QUERY	CCCGGGTTCACAAACCACAAACTGATGTGAAAGAGATGAAGAAACAGGAAGCCCATTGGGGCCAGCCTCTCCACAGCCCACTGGGAAACGCACAGCCTCACTGTCCCACCAAGACACCACTGTCCCTCGTCTGGGTGGGTCAATCCTG	52	62	64	54	-10
2S43D:09342:10719	INITIAL_QUERY	TGTGCTGCAGCTGCATTTCCTGGAACCCTTCCAGCTCTCGTGCTCATCCCCCATGATCGCTGTGGGAAGTGATGATAGCAGTCCAAATTCAATGGCCAAGGTTCAGAATTTTTGAATACAATTGAAAATAACCAGGAAATAATGCGAAAGCTGAGACTCTTATTGACAGTCACAGACCCCGTCCAA	6	16	87	77	-10
2S43D:03317:07579	INITIAL_QUERY	CCCTGCTCCCTACCAAAGTGTACAATTCGGTGTTCCGTCCACTCTGGGCAGCCCTCACTGCCCAGCGTGGAAGGGAACAACGAAGCGATGCTGCCAGGCGCGTCTGTGCCCACTGGGCTAAGCCGGATGGTACAACAGACAGCCAA	81	91	131	141	10
2G5Z3:04087:09358	INITIAL_QUERY	CCTGAGAGTTCGAGTAGGAGGAAGAGGGGGCGCTCGGAGGCTCATATTGATACTGCGCAGGCGGCTGCTGGGGATGAAGAAGTCGCAGGTTTTGGGGTCTGAAAGCTGGTGCTGAAGGTCTGGCTCCGTGTCCTCCTCGGCCCCGGGGACACCCTCGTCCTGGGTGGTGACGACATCTATGACCTAGACTCTTTGACTAAAGTTGCCACGGTTCCCCAGCATGCAACCTCAGGCCCAGGTCCTGCTGATGTCAGCAAGGTAGTAGCCAAAGGCCTGGGGCTAAGCAAGGCTTATGTAGGCCAGAAGAGCAACTCACAGTAGATTCAGCAAAGCAGGTAACAACAATGCTGTGGTGGGCGTGCGATGGCCCAAGGCACCCTGTGAGAGATCCTGGTGAAACTCGAATGGGCGCCCAGCCTCTATATGTCTCTTACCTACGA	187	197	152	142	-10
2S43D:08249:12291	INITIAL_QUERY	GGCAGGAACAAAGATTTCTCCCTAACGCCTTTCTAAAAGCTCAGGTAAGGGGACCCAAAAACCAGTACAGGTGGCAGCGTGCTAGTGGCAATCTTGGCAGAAGAGAACCCGTTGAGAAGGGAAGACACTTGGTGTTCTACTGGTTGGCCCCCAATTCAGGTTAAGATAAGTAGGTTGGCTACTAGGATTCAGTACAAAATTTGTGTGATTGGGCGGAATATTAGGCTTCGTTGCTTTGAGGTATGAAGGAAAGGTATTAGGGCTAAAATTAGGATAGATAAGATTAAGGCTAGGACAGGTGGGTCAGGGCTGCTGGGGGAGCCACGGGGATACTATACAGAGGGCAGGGCTTCTTCCAGGAGGCTTTAATCCACCTCTTCCATGCGCGAGGCATCCTCATCGCCTTCCAGAGGGGGGATCTCATCAGGAACAGCAGCACTGGGCTCCTCTGCAGTGACCTCATCTTCATCGAATGCCCAGGCCTAGTTTAATCATCTCCACTTCGGCCTTCAAAGTTCTCGTTTGAATATTTTGCTACTACCACCAAGATCTGCACCTGCGGCGGCTCCACCCGGGA	365	375	557	567	10
2G5Z3:06068:13168	INITIAL_QUERY	CCCCCCCCTTTGTTTGTTTTTTGTTTTGTTTTAAAGAAAGGTCTCACATAAGAGCCCAAACTGGCCTTGAACTCAGTTCTTCTACCTCAGCATACAGAGTTCTGGAGGGGCGCAGGTGGCAGGACCTTCACAGTTGGCAGGTGAGCATCGTGGGGTGCAGGCGTGGGCGGCCTGGAGCCCTCCCGCCCTCCTCCGGGCACTTGCTTTCAATAGCGGCAAAGAAAAACAAAACAAAACAAAGCCAAGTGGGCAGGGCAGGGGAAGGGACAGGGACGAAAAGGAGACAGGCCATCGTAGCGCCCTCCAGCAGCTATGCTGCCCACACCCAGGGGCTCTTCCCCAGCTTGGGTTGGCATCTGTAGCAGCACTGCCTCATAGATGACCCCAGTATAG	267	277	258	268	10
2S43D:10100:12013	INITIAL_QUERY	CTCTATGTGGTTTGGAGTCATGTTCACTTTGTACTGTGCTTCCTGGCTTTGATTATGTTCTCTCTCTTATGTATAATAAACTTCCTACTCCATCATAAAAAAAAAGAAAAGAAAAAAAAAGAAAAAAGAATGCTTCCTCGAGCTGGCTCCAGACTTTGTTGGGGATATCCTGTGGGAGCATCTAGAGATCCTGCAGAAAGAGGATGTGAAACCATATCAGGTTAATGGAGCCAACCCTACCTACCCAGCAATCCTGTTACACCTCGGATTACTTCAA	303	313	184	174	-10
2G5Z3:05291:03840	INITIAL_QUERY	GGCGATTTCTCCAAGAACAGGCTGTTAGCACCGCCTCCGAACACCTGGGACACATCAAGCTGCTGCTGTGCAAGTGCTGGCTCCACCGCTGCCGAAGGGGGCCGTGGTGCTGGGTGCTCGGGCCTTCCACCCCATCGAAGAAGAGGCTGGGGTGGTTAGAATACGACAGATGCTCCTGTACCTATCTGGGTGAGGTGGTGGAGTGTGGGACGGTCATGTCTTGATGTCCAGCAGGGGCATCCGCTTGTGCTGGTAGCGGCAGGATCTCATTTGCACATTTCCTAAGGGGTCCTGAATCTGCTCACAAAGAAGCATGTGGGGCAGGATTCCTCAAGTCGACCCCGTGGGTGAACACGCACCCAGGGGTGGGGGTCCAGTGCTCAGTTGGCCCGTACTTTCTTCCCCCTTTGTCTAAGTAATTTGTGGCTTTCCTTTTTAGCTGACCCATGTTGTTGTGCTGTCTTGAGAACATCTAATTCCGCCTCAAGTAAATAAGACTCCAAAATCAGCCAACATCAATCATTCTTACCTAAAGAATAATAAATAAACGTTAGTATAAAAGACAAGGGTATAATATTTATTATTGATAACACAAAAGGTCAAACACTGGGACTTGGGAATACCAGTTTTTCAGATCCGTTTACAGGTGGTGGTCGCTATGTTCCAGGAACTTCAGGACCTTCCAACA	302	313	257	268	11
2G5Z3:02929:09876	INITIAL_QUERY	AGAAAAAGCATGCAGGTCATTAATTGATATTAGCAAATTTTGTTCACTCACTTAGCAGGTCTTAAATTGCCAACGTCAGCTCCAGCCACGATTCTATTTCCACATCAAACAGATTCCATAAATA	207	217	82	72	-10
2G5Z3:05271:10272	INITIAL_QUERY	GTTAGCCTATCAAGAAGTCCCTAGTAAAGAGCAGCCTGATGGATGCACTAGCCAGCCCTTTTAGAGAGCCTTGAAACCTGCTTCCGTACGCCACATTTCCCACGCCGCGACGCGCGGCGGGGATTCGGCGCTGGGCTCTTCCCTGTTCACTCGCCGTTACTGAGGGAATCCTGGTTAGTTTCTTTTCCTCCGCTGACTAATATGCTTAAATTCAGCGGGTCGCCACGAGGGCCGATCACTTCGTGGCTTTGGCACAGGGAATTCTCCATGTATTGAACCAACAGAAAGTGGAATGTATGGGTCTTATTAAAGGTAGTTTTCTGCTGTTTTGCCTGTATAATTACAACCCTGGAGTAATCTGAAGCGGGAAGCTGCCGAGGTTACCAGAAAGGTGGAGGAGACATGATATTCGTCATGCAGGAGGTGGAGAACCGTGTCCCAGCAGTACCTGCCA	260	273	358	371	13
2G5Z3:05271:10272	INITIAL_QUERY	GTTAGCCTATCAAGAAGTCCCTAGTAAAGAGCAGCCTGATGGATGCACTAGCCAGCCCTTTTAGAGAGCCTTGAAACCTGCTTCCGTACGCCACATTTCCCACGCCGCGACGCGCGGCGGGGATTCGGCGCTGGGCTCTTCCCTGTTCACTCGCCGTTACTGAGGGAATCCTGGTTAGTTTCTTTTCCTCCGCTGACTAATATGCTTAAATTCAGCGGGTCGCCACGAGGGCCGATCACTTCGTGGCTTTGGCACAGGGAATTCTCCATGTATTGAACCAACAGAAAGTGGAATGTATGGGTCTTATTAAAGGTAGTTTTCTGCTGTTTTGCCTGTATAATTACAACCCTGGAGTAATCTGAAGCGGGAAGCTGCCGAGGTTACCAGAAAGGTGGAGGAGACATGATATTCGTCATGCAGGAGGTGGAGAACCGTGTCCCAGCAGTACCTGCCA	587	597	402	392	-10
2S43D:04065:14730	INITIAL_QUERY	ACATTTTTAGCTACTACCTTGAGAACTGATATGGAGCTTGGATCAAATTTAGATAGAAATAATTTATTTTATGAGAATCCTGAGAAATCCAGGATGGAAAGAGCTGCCTGTAGAAAGACTAGCCGTTGTTTCCATGTGCCTCATGCACATCTCAGAAATTTTGTGTTGAGAAAGTAAAATATGTTTTCAATTACAGTGAAGAGTTCGAGTGTCATAAAAGGCATTACACTACAGTTAATGTGTTACTATCGTCGTAGTGCAAGTCAAGGGTTTCAGAAGGTTAGGTAGTTTAATACATTTATTACAGCAGATGTAGCCGTGAGGGGTTGTTGCGTACTGCGCACATGGTGTGTCCCATGGCATGCGGTGTACCAGTATACAGCTGCCCGTCTGTGCTTCGCTTCACTGGTTCCTTTCTGATCCCCATCAGGCAATGCTCCTTTGTTTCTCTGGAAAACTGACCTTTGGATTCTAGAGTCTTTGTTCTCAGCCGAGTCCACCAGGCGGGCCAGCCTGGCTATTGCTTATAAAAAGTAATAATTAGTCGCGAGGCTTGCTATTTACAATCACTGGCACCCCCCATCCCAGCCTTCCTGGGAAGGGGGCACCCTCGGCAGTGACTGGCAGTTTATTTGAAGAGTTTTGCACAGTGTATAGGGAAATGCTTGGTGGTTTTAGAAATACTCCCCAGGTTATGTCTAAATGGAAAAGAGGGGAACAGGGCCTGGCGGTGGCAACTGTCAAGACACTATAGACCCTCACCTCCAAAACTGCAGA	407	417	663	653	-10
2S43D:04321:07332	INITIAL_QUERY	GCGCTCTCCACCACCCCTCCAAACTACAACATGAATTGGCAACATGGGAGGAAAAAAGAACCAGAACTTCCCAGGCCCTACATTTTTTCTTAAAATACTTTAAAAGGAAAATTTGTTTGTATTTTTATTTAACATTTTATATTTTTGTTACATATTGTTAGGGGTCAGCCATTTTTAATGATAACGGGTGACCAAACA	141	151	52	42	-10
2S43D:02669:09352	INITIAL_QUERY	GTTCCCAGTGTCTCCAGCTCCGGCCCTCGTGTCTTCCTGCACCTGCTGAAATGCAGCTTCGATGTGGTCAAGCGCTGGGTGAACGAGCCCAGGAGGCGGCGTCCAGTGACAACATCATGGTTCCAGTACCATGCCCTAGGAACTTCTGTACCATAGTGCGGAAGAATGAC	253	263	103	93	-10
2G5Z3:07757:07308	INITIAL_QUERY	GGGCAATTAGCAGTGGAATAGAACCGATTAGGGTAGTAAAATAAGGAAAGTAAAATACCCTCGCGTTTAGGCGTTTCAGTTTGGTTCCCTCATCGGGTAATAATAATAAGTGTTGATTGCTCACGAACCAACCAGGAGCTGCAAGAGATCAACAGAGTGTACAAGGAAATGTACAAGACTGATCTGGAGAAGGACATCATCTCTGACACATCTGGAGACTCCGAAAGCTGATGGTCGCCCTTGCAAAGGGCAGGACGAGCAGAGGATGGCTCAGTTATTGACTACGAGCTGATTGACCCCAGACTCTCCAGCACCCAGCAGCAGCAGGCGGTGCGTGGCCCGGTAGACCTGCTTGTCCTTCTGCAGCTGCTTCTCGATCTTTTTGTTGGCCTCGCGCTGCGCCTTCTCCTCGTTGCGCTGGTCCTCGGTCTTACACCTCTTTTATTTTAAAATTGATATGTATATACAACTCGTGTGTCTACATCTAATCCTACTGTGAAATATGTTGGTGGGCTCATACAATAAAGCCTAGCAAAAGCCCGAATAGACAAGTTATTTACATCCCCTATCACTAGATAAAAGAGAGGAAAGGAGAGAGAGGGAAGAAAAGAGATCCCTGAAGAAAGCCAGGAGTCAGAAAGGAGGCAAGGTTATCATTAGCATACTTCCTGCTGATTGA	186	196	249	259	10
2S43D:07665:04050	INITIAL_QUERY	GATAGCATAGACAGTGATCAAGAAGATCCCCTGAAACATGCTGGTGTCTATACAGCTGAAGAAGTGGCTCTTATTATGAGAGAAAAGCTAATTCGTTTGCAGTCTTTGTACATTGATCAGTTTAAAAGACTCCAACACCTGCTCAAAGAGAAGAAGCAGAAGGAGGGAAGCAGTGTGTAGAAAGAAAAATGCCCTTGAGGGCTCCACCCTGCCTGCCCGTCACCTCAACGTCTGTAGCTTTAGTACACTCAGGAAAAGATGACCATCTTTTGTAGAATTGTTTATATCATGTTTCGCATTATTTCAATTTCCACTTTAAATTTTTTTAAAGGTACTTTTAAACTGGGCCTTCTTATTAAAATTTAAAATGATGAAGATGACAGCAGTGGAGAAGAGGAGGTGTCATCCCTCAGAAAAAAGGCAAAAGGCTACCGACAACCCCAGACTTTGTTGGGTGGGACTATATCGGCATACAAGATAGTACCAGATGAAATAGAAGAAATCAAGGAAACACTCATAGACTGGTGTGATGAAAAGGAACTTAATTTAATATTAACAACTGGAGGAACGGGGTTTGCACCACGAGATGTCACTCCAGAGGCCACATCAGCCTGCAGCTTCCGCTCCTGTTCTTCGCGTTCCCTCTGTTCCCGAGCCTGGCGCCGCTTTCAGCCAGGAGCCGCGTGGCTTCCTCTCGGTCTGTGGTGCCGCCATGGGAGTGGTATTCCTGAAAGGCCCAGGAAATGTTGAGGGAAGAATGTTATGCAGTAGACGCCTACTATTATCATCAATGAGAAACACAGCTGGGCTGCTGCAGCCAGCTCTCAGTTCTTGGGGTCTCTAGATAAGAC	519	529	652	642	-10
2G5Z3:01845:05736	INITIAL_QUERY	TCCATCTCAGCAGCCTCCTTCTCAAACTTTCGATGGTTCGCTTGTCGATTCACCACATTTGTGATCGCCAGCATGGAGGGAGCCAAGCCAACCTTGCAGCTCGTGTACCAGGCGGTGCAAGCGCTTTACCACGACCCGGACTCCCAGCGGAAAGGTAGCGCTGCCTCGTTTTGGCTTGGGGAGCTGCAATCAATGGGAGCGTGTTGCTATCATAAGCAGGATTTTA	191	201	159	149	-10
2S43D:07274:10096	INITIAL_QUERY	CAGCAGGGTTACTGCAGTCATCCCATGCTTCCCTTATGCCCGCCAAGATAAGAAGGATAAGAGCCGGGCTCCAATCTCGCTAGCTTGTTGTCAAATTATGACTATCTGTAGCAGGTGGCGGATCATATTATCACCATGGATCTACATGCATCTCAAATTCAGACTGAGGTAAGGACTGAGTTACAGAGTTTCATTGAACAGGGAGGTTGGGAGTAAGAAAAAGAGAGAACTTTGTTGTCATGGAAAAGGATTGGAATTTGGCAAATGGCTGATGGTTTGGAGGTGTGCTCTTGGAGAGGTTGTACAACCCTCTGTGACAGGGGAACTTGATAAAG	352	362	264	274	10
2G5Z3:05250:04303	INITIAL_QUERY	GGCTCTTTGGTTGAAATCCGAAATTTCTTGGGTGAAAAATACATCCGCAGGGTTCGGATGAGGACAGGTGTGGCTTGTTCTGTCTCTCAAGCCCAGAAGGATGAGTTAATCCTTGAAGGAAATGACATTGAACTTGTTTCAAATTCAGCTGCCCTGATTCAGCAAGCCACAACAGTTAAAAACAAGAGCCAGCAAGACACTGTGCTGGGATGGAGGAAGGGCCTCCCTCCAAGCTAAGCCTCACACCTGGCACCAGTACTCTCAGGCCTCAGCAGGACAGGCCTGGAATAGGGCAAACAGACTTTTGGAAGCCAAGATCTAAATACCAATTCCTGAGCAGGACCCACATCCAGCCAGGCGGGGTCTCCTTGAAGCGCGGCTTCCCGGCTGCCGTTCTCGGCAGAGTCGGCCTGCAGTTTCAGGCCTGTCGAGGGGCACAGACAGCTGCTGCTGCAGCTCCCAGAATCAAAAAATTTGCCATTTACCGATGGGACCCAGACAAGACTGGAGATAAACCTCGAATGCAGACGTACGAGGTGGATCTGAATAAGTGCGGACA	332	342	393	383	-10
2G5Z3:05499:01306	INITIAL_QUERY	GACCAGAGAAGCTGAAGAGAAAGAAAAAGAGGGCATTAGTAAAACAAGAACATCGCTTGGGTGATTGTCCAGATCATCCTGATCGACAAGACCGGCTTCCATCCGAGTACGTGCTCGCTCGATGCGATGTTTCGCTTGGTGGTCGAATGGGCAGGTAGCCGGATCAAGCGTATACAGCCGCCGCATTGCATCAGCCATGATGGATACTTTCTCGGCAGGAGCAAGGTGAGATGACAGGAGAATCCTGCCCCGGCACTTCGCCA	45	55	53	63	10
2G5Z3:05499:01306	INITIAL_QUERY	GACCAGAGAAGCTGAAGAGAAAGAAAAAGAGGGCATTAGTAAAACAAGAACATCGCTTGGGTGATTGTCCAGATCATCCTGATCGACAAGACCGGCTTCCATCCGAGTACGTGCTCGCTCGATGCGATGTTTCGCTTGGTGGTCGAATGGGCAGGTAGCCGGATCAAGCGTATACAGCCGCCGCATTGCATCAGCCATGATGGATACTTTCTCGGCAGGAGCAAGGTGAGATGACAGGAGAATCCTGCCCCGGCACTTCGCCA	289	299	252	242	-10
2G5Z3:08275:05566	INITIAL_QUERY	GCCACAAATTAGTTGGAGAAAATCTTTAAACTGATCTGTAATCTCATCTCCAATGGGATTTTTCACTATTCAGCCAGCCTGGCCTACATCTTTTTGTCCTTGTCTTTTCTTCCCGTAGCAATTTAACCTAGGATTTTATTATTTTAGCTAACATCTAGCTATCAGTTACTCATTCATGATCAGGATGAGCCTACAAACATCCAAATACTCATCAATTGGGAGCTTTAGAGCCGTAGCCAACAATTCATATAAGTAACCATAC	466	477	177	188	11
2G5Z3:10349:08560	INITIAL_QUERY	GCAGGAAGGACACGGCTTTGGTCAGCTGTGCATGGATGGTCCCTAATGTTCCCTCTGAGAGAAGATGAGTGAGCCTGGCTATCCACTCTGACCCCCTCATCTTTCCCTCTTTGGGGTATTTTTGATGGGTTCTGGGGCACAGGGCGTCAGAAAGTTCTCATCTGTCAGTTCCGGTACAAGGAATGCCAGGCTGAAACATGGACCCGGCTGGAGCCCCAGCTGAAGACAGATGGGCTGACTCCTGTTGAGATGCAGAACCTGGAACCTGGCACCTGCTACCAGGTGTCTGGCCGCTGCCAGGTGGAGAACGGAGATTTTTTTTTTTTTTTTCTGAAAGCTTTTAATGTATCCCTCCCAAACGAACAACTGCAATTATAGAAAACTTTCCACTCTCAGATCTGATGACAGAGATCAGCACTGGTGTAGAGACTACTGCAAATAGTAGCACTTCTCTGAGATCTACAACTCTTGAAAAAGAACGTCCCAAGTAATCCTTCATTCACCC	520	530	69	59	-10
2G5Z3:01669:14496	INITIAL_QUERY	ACTGATTCCGTTCCATCCTCGTTGCGGATGTGTGTTCACCGAGTCGGTGGAGAAAAGAGTGTCAGGCTCTAAATTTTTTTGTTCATTGTTTTTGTCCCAGGCCTTTTCTGGTCGTAGTGTTTGTGTTAATGGCGAGATTTCAAAGTTATAAATTTATTAAGACACTGCTGCTAAATTCCACAAATCATTAATTCATTATATTAGGGACATGATCATCCTGCCGGAGATGGTGGGTAGCATGGTGGGCGTGTACAACGGCAAGACCTTCAACCAGGTGGAGATCAAACCAGAGATGATCGGCCACTACCTGGGCGAGTTCTCCATCACCTACAAACCCGA	469	479	210	200	-10
2G5Z3:03274:11727	INITIAL_QUERY	CAAGAAACAGAAAGTAGAAGGCTCAGAACCAACTACACCTTTCAATCTGTTCATTGGAAACCTTAATCCAAACAAGTCTGTTAATGAATTAAAATTTGCCATCAGTGAACTTTTTGCTAAAAATGATCTTGCTGTTGTGGATGTCAGAACTGGTGAGCCCGGGTGGAGCCGCCGCAGGTGCAGATCTTGGTGGCAGTAGCAAATATTCAAACGAGAACTTTGAAGGCCGAAGTGGAGAAGGGTTCCATGTGAACAGCAGTTGAACATGGGTCAGTCGGTCCTGAGAGAAAGGAATGTTGCTCTGGAGGAAGAGGAGGCGGCTGCGGAAGGGTCGTGGGGTCTGGGTTTGCGAGATTAGGACGGACAAGGAGTTGGTTA	365	375	166	156	-10
2S43D:09939:04858	INITIAL_QUERY	GCCAATGTAGCTCTACTCTTTATAAATAAGTGTTAGGTAATTGAGAAGACCATCCATCATGAAGTGTGGGATATGAATACATTCCAGAGCATAGCCTTTTGTAATTTTAGGTAGTTATCAGTTCTCCACTAGCTCCATGTTCTAGCTTTTTCCTCCCACAGGACCTTGGGTAAACCAAGATATTCTGGTTACATTGATGCTCCGCTGCCTCACCCTGTCCCACCCCACACACCCCAGGCTCAAGCCTTGATGATTCAGTGACTGTACTGGGTGGGAGCCAGAAACCTGACCATTTTGTTGTCTACATGAGCCTAGACTAGCCCTGTGCAACGAGACACACCCAGGAGGAGCTGAAGGTTCCTAGGGTCCCCTGGGACCTAAAAGGAGCTGGGCTTTTCCTGAGCTGGGGGGATATGGAGAACACATGGGGGGATGGTCAGGGGCTCAGCTGCAGCAGAGCCAACAGCTAAGCAGGAGTCCAAGGCCCAGTAGTGGGATACTGGA	521	532	233	244	11
2S43D:01707:13039	INITIAL_QUERY	GTGATAGTGATCCAGAGCTGGTGCAATGGAAAAAGGAGCTGCGTGATGCCTACCGCGAGGCCCAGCAGCTGGTACGCGAGTACCCAAGATGAAGAACAAGCCACGCTCGCCTGTGGTGGAGCTGAGCAAGGTGCCGCTGATCCAGCGTGGCAGTGCCAACGGCCATCTCGATCGGGAATTTGATCTTGGAGTCGTGGAACTGCTTGACAGCTGGCCGGCGGCACTTGCCAGCTGCAATCTCTTCCACCTTCATGATCTGGATGGAGTGGGCACGGGGCATGGTGTCGGGCACCATGTCTCGGTAGCACTGTGTGACACTCAGAAGAACTCGTCAAGAAGGCGATAGAAGGCGATGCGCTGCGAATCGGGAGCGGCGATACCGTAAAGCACGAGGAAGCGGTCAGCCCATTCGCCGCCAAGCTCTTCAGCAATATCACGGGTAGA	473	483	251	261	10
2S43D:01707:13039	INITIAL_QUERY	GTGATAGTGATCCAGAGCTGGTGCAATGGAAAAAGGAGCTGCGTGATGCCTACCGCGAGGCCCAGCAGCTGGTACGCGAGTACCCAAGATGAAGAACAAGCCACGCTCGCCTGTGGTGGAGCTGAGCAAGGTGCCGCTGATCCAGCGTGGCAGTGCCAACGGCCATCTCGATCGGGAATTTGATCTTGGAGTCGTGGAACTGCTTGACAGCTGGCCGGCGGCACTTGCCAGCTGCAATCTCTTCCACCTTCATGATCTGGATGGAGTGGGCACGGGGCATGGTGTCGGGCACCATGTCTCGGTAGCACTGTGTGACACTCAGAAGAACTCGTCAAGAAGGCGATAGAAGGCGATGCGCTGCGAATCGGGAGCGGCGATACCGTAAAGCACGAGGAAGCGGTCAGCCCATTCGCCGCCAAGCTCTTCAGCAATATCACGGGTAGA	322	332	123	113	-10
2S43D:03943:00694	INITIAL_QUERY	TGTCAATTTTAATTTACATTCTTCTGGTTGCTACATTTTGTTCTCTGACTCACGGAGCTGTGCTGGCAGATCTGACAGGTGAGGAGTAGATATAGACAGCAAGCAGGCTGCTGTTAGATCCTCTACCAAGCAACCAGGAAAACATGAGTGCTGAGATCAAAACCTTGTGCAGGCTACACAGATGGTGAGCTACATTCCCAGTCACCTGCAACTGTTCTCTTAGGGATGAAGAGGACCTGCTGTCTTAGACAGCAGTCAGGAAACACTCA	577	587	98	88	-10
2S43D:02720:02145	INITIAL_QUERY	AAGCTGCGAACCACGCCACAGCTGCACCTCAAGACAGTTACTGTTCTTGCACAAGTTCACCCCACTCCCCTAAGAAGAAAGGGAAATACCCCAATTTCTTGAAACAGAAGCAGCCTGAGCTGGAGAATAGTCGTCTCTGACCCAACGGTCAGTGCACAAGGCCCACAGTTTGTGACTGGAGTGATTGTGAAGATTGTGAGCGGAGAGCCTCTACCGGGTAGGAAACAAGTCAAGGATATTTTGGCCACAATCTCAGAAGTTGTTTACATTGATTTGCTAGAAGGAGATACTGAATAGTGATGTTGAAGTGAATGAGAAAAAAGACAGAGTTACTGATGCTCTCAATGCTACAAGAGCAGCTGTTGAAGAAGGCATTGTTCTAGGAGGGGGCTGCGCTCTGCTTCGGTGCATCCCAGCCTTGGATTCATTAAAGACCTGCTAGGGCACGGAGGCCATCGCCCGTCCCTTCGGAACGGCACTCGCCCATCTCTCAGGACCGACTGACCCATGTTCAACTGCTGTTCACATGGAACCCTTGTCTCGCTGTATGGTCCCTGCATGACACTGAGTCCATCTGTGAGGGCTTCCGCTGGTACTCAGCACACTAGTCAGGCCCTCGAACTGCTGCCTTTCTCCGAGTGACTGGGGTTCGATTGGACGGGGAATTTGGTAGGCCATCTTTAAGATGAAAATGTGTTCCTTTTTTGTCACATGTTCCTTATTCCCATTACAACCACAATGGTTGTGAATGAAGAGTAACAAAGAATAACGAAGTCTACTTTATTTGAATTATACTGGTCATTTCACGGATCATCTTGTGAAACCCACACCAGAGTCTCTGTTCAGAGGACCCAGGCTCCAGCTGTGGCTACCACATAAGGGTTTTTATATGAGAAAAATAAAAGAATTAAAGTCTGCTGA	486	496	332	322	-10
2S43D:09858:13844	INITIAL_QUERY	CTTCTTGATGCTCTCCAGCATGTCATAAGGGCTGTAGCTCTTGTACCTTCGAACACTTTCTGGAGGTGCACACACTGCGCTCAGTCATGATGCTGATCCGCTTGGGACCATTTTTAATCCAGTATTCATAAACTTCTCTAATTAACTGTCATCTATCTTCTTTTAGAAGTAGTTTGGCTTCCTGCAGACATGACTGGCTGCTGACCGCTGCTTTTTCTGCTGACCCCAAATCATAAAATTTTTCGTTGCTACTTTCTCAGCTGTAATTTTGCTGTGTTTTCTGATGATCTTAGAGGAAATGCGATGATCAACCCACAAGGGTTGAAAACCTTAGACAAGTA	274	285	191	202	11
2G5Z3:07094:08903	INITIAL_QUERY	GTCAGGCAGCCCCTCTCCCCACCCTCGGCACTCCTCAAGCCAATAGTGCAAAAGGGCAGGGCAAGCCCAGGTCAGCAACGGGGACGTCCCCAGCCCAGCCCCATCCACTGGGCCCGTAGGAGGGCCGCTGCGGTGAGCCTTGAAGCCTAGGGCGCGGGCCCGGGTGGAGCCGCCGCAGGTGCAGATCTTGGTGGTAGTAGCAAATATTCAAACGAGAACTTTGAAGGCCA	365	375	167	157	-10
2S43D:03609:14755	INITIAL_QUERY	GTTGGGGCACTGGCGAGCCGGGGACACAAAAGCGCGAGTTTGGATGTGCACAGGGTTCCTTGTCACCAGGTTTCCAGGGCTTTCCCAGCCACGAGGTTATGGTGACACCAGGCGGAAGAGGCTGGTCAAATGCCCTTCCCA	208	218	84	74	-10
2S43D:02521:07819	INITIAL_QUERY	ATCCGTCCACGGGCTGGGCCTCGATCAGAAGGACTTGGGCCCCCCACGAGCGGCGCCGGGGAGTGGGTCTTCCGTACGCCACATTTCCCACGCCGCGACGCGCGGCGGGGATTCGGCCGCTGGGCTCTTCCCTGTTCACCACGACAAATGTGTGTTACTGATGAAAAGGCTTGTTATTGTATCTGATGTGTAGTGTATGGCTAAGAAAAAAGACCTGTAAATGATTTTGGACTAATTAGGCACTAACTTAAGTAAAACAGTATAATTTTGCTATTAATAAAAAAAATTCTAAGAATTTTCAAGAGATAAATATAAAATTGTGTTAAAAGGATTTTTAAAAAAAAGTAGGTTACACATCGATACTAAACATAATTCTCATCGACTACGAGCAACTGCAAAAGGCAGCAGGAAATCAAGGCCCTATCCTTTCAACTCATTGATCCGTTCCATAAAGCTATCAGAAGAAATCCTGACACCCAGTGGATCACCAAACCAGTCCACAAACACAGAGAAATGCGTGGCTGACATCTGCTGGCCGAAAGAGCCGTGGCCTTGGAAAGGGCCACAAGTTCCACCACACTATTGGTGGTTCCCGCCGTGCAGCCTGGAGAAGGCGCAATACTCTCCAGCTCCACCGTTACCGCTAATACACGTGACTCTGGAAAGCCTGTGGCGTGATGGCCGTGGGGCTGCCCAGAACATCATCCCTCGCATCCACTGGTCGCTGCCAAGGCTGTGGGCAAGGTCATAGTACTTCTACTGTTCGCAGTCATAGCCACAGCATTTATAGGCTACGTCCTTCCATGAGGACAATATCATTCTGAGGTACCACAGTTATTACAAACTCCTATCAGCCAT	67	77	767	757	-10
2S43D:00045:11989	INITIAL_QUERY	AAGAAGCCCAGGACCAAAGCACCCCAAGATTCAGCGACTTGTTACTCCTCGTGTCCTGCAACACAAACGCCGACGTATTGCTCTGAAGAAGCAACGCACTAAGAAGAACAAGGAGGAGGAGAAGCCTAGGGCGCGGGCCCGGGTGGAGCCGCCGCAGGTGCAGATCTTGGTGGTAGTAGCAAATATTCAAACGAGAACTTTGAAGGCCGAAGTGGAGAAGGGTTCCATGTGAACAGCAGTTGAACATGGGTCAGTCGGTCCTGAGAGATGGGTGAGGCGGCTTTGACTTACAGTTGTCTCTGCTATATATTTATGTTGCCTTTTGTTTTCTTGTTTTTAGTAGGAAAAAAACTTTGGCCCTTGTAGTGAGTACACTGTAGCTGTCTTCAGACACTCCAGAAGAGGGCGTCAGATCTTGTTACAGATGGTTGTGAGCCACCATGTGGTTGCTGGGATTTGAACTTCAGACCTCGGAAGAGCAGTCGGGTGCTCTTACCCACTGAGCA	365	375	146	136	-10
2G5Z3:01794:03338	INITIAL_QUERY	CTCTGTCATAGTTTTCCCTGTCTCTAAAGGTATTAAATCCACCCCTTTGCCTGCAGAGTATCTGTCACGACGATCGCTCCTTCATGCCTCCCTCTACCCCTGGAACGACCA	557	567	63	53	-10
2S43D:04088:03171	INITIAL_QUERY	GTCTATTTTGTATGGTTTGACAGGCTAGCTCTGCATGGGACAAAATGCACTGGGCAAAAACTATGGGGAATCCGGGATGGACGCCGCAGACCAACGATTGGCGTATGACTTGCAGCACCTCTTCCTTAAGACAGTACGATGAGACCAGCTTCCTCACAGGTTCCACGAGTCATGTCAACACAGCGTGTTGCTAACACATCAACACAGACAAATGGGTCCACGTCCTGCAGCTGCTGCTGCTGCAGCCACTCCTGCTCGTCCGCACCTCGTTCCCAGTAATAAATACTGCGTGCGGGACATCCCCGCAATCCCCAAGCAACATCATTAACTAGCAACGCCACATTTGCAGTGGCAAAGTGGAGATTGTTGCCATCAACGACCCCTTCATTGACCTCAACTACATGGTCTACATGTTCCAGTATGACTCCACTCACGA	184	194	220	210	-10
2S43D:07462:11230	INITIAL_QUERY	CTTAAAGGGAAACTTACACAATGTCCGGAGCCCTTGACGTCCTGCAGATGAAGGAGGAGGATGTCCTCAAATTCCTTGCTGCGGGAACCCACTTAGGTGGCACCAACCTTGACTTTCAGA	184	194	37	27	-10
2S43D:08541:10246	INITIAL_QUERY	CTCGCTCGATGCGATGTTTCGCTTGGTGGTCGAATGGGCAGGTAGCCGGATCAAGCGTATGCAGCCGCCGCATTGCATCAGCCATGATGGATACTTTCTCGGCAGGAGCAAGGTGAGACTGACAGGAGATCCTGCCCCGGCACTTCGCCCAATAGCAGCCAGTCCATCTTCTAGGCCAAAGCCAGCTTGTCTCGCTCAGTCCCCTCAAACTGCTTGCCCCAGCCCCCCTGTGGAATCCATAAACATGTGGGGATGTCTTTGCCGAAGTAAATCTTGCTGTTGGAAGCAATTGGCCCTTGTACTTCATCAGCTGACAGGTATTCTTGGAGTCAGCTTGAGCTTTATTGCTTGGGGCTGCGATCTTTCGTAGCGACATTGTTCCTCTGATCCGCATCATGGTCTCCAGGAGCGAGCTGGATATGCTTGACATCCGGGAGATCTTCCGGACCAAGTATGAGAAGTCACTCTACAGCATGATCAAGAATGATACTTCCGGTGAATACAAGAAGGCTCTGCTGAAGCTGTGTGGAGGAGATGATGATGCCGCTA	273	283	155	145	-10
2S43D:01173:09721	INITIAL_QUERY	GGAGACGATGATGGTGAGTGCCAGAAGATACGGGCTGGTTCCAGCAGAGCAACCTTCACTGAATCCTGCTCCTCATCCGATTGCTCATACAGCTCGTCACCTAAGAAGTTCCAGGGTGACTTGGTACTCTGTGCAGCATAGGAGTTGCCAGCGCCATAGTGACAGCGGGCAGGACGGGGATAGACACCCAGAGCAGAGAGTCCTCAGACACTCAAACACAGTATGAGGCCAACAGACCAAAGTACAGTTTCCAGGGGCTGCAGATGTGCTGCAGACTGCAGTCTGAGGTGGAGAGGCAGGGGCAAAAGGAGGGTTTGGAGCAACTGACTGGGGAGATAGGGTGGTGGGCAGCATTTCAGGCTTGAGGGTTGATGA	51	62	286	297	11
2G5Z3:02634:01900	INITIAL_QUERY	GTCACTTTTCCTTTTGTAGATGTACTGCTCCATCTGAAAGTCAAGGTTGGTGCCACCTAAGTGGGTTCCCGCAGCAAGGAATTTGAGGACATCCTCCTCCTTCATCTGCAGGACGTCAAGGGCTCCGGACATTGTGTAAGTTTCCCTTAAGTTACGATGGGAATCAAGAACAACGCCGTATGGACCCGTCCCCGA	184	194	105	115	10
2G5Z3:00154:05246	INITIAL_QUERY	AGAAAACTTTATTCATGAGGTGGCTTCTCTGTGTGAGGATTTGCAGTCTTCTCCCAGGGTCCCGGCTAGCTCTTTTCCATGAAGGCCAAAGAGTCAATAAGGCTGTCATACCAAGCAACTGACAAAGACAGTGGCTGGAAGGCCACTGTCCAAGGCCCAGTCCAAGAAGAGTACATGGTGGTGTGGGAGTTCTTGGTTCTTCAGCCACCTCTGTGAGTGAGCTTGGGTTCGTGGGTGTGAGTCTCTGTGTTAGACACTTTCAACAATGCTTAGCATTAATCCAAACTCTTCCCATTAGAATATAGTTTCTTCAACCCTCGCTCTCCTCCCAATCACGGCCTATCAAATAGTGGGTGTTACAGCTGAGGGCCAGACTCCACCCAGTGACAAAACCAGTAGAGTCCATGGACTGGGCTTTTGTCTTGTTTCTATTATCTGAAGGGCATCTTGGGCTACACTGAGGACCAGGTTGTCTCCTGCGACTTCAACAGCAACTCCCACTCTTCCACCTTCGATGCCGGGGCTGGCATTGCTCTCAATGACACCCGAATCTCAGTGAGGCCTCCTTGGTGAACACGAAGCCCACGTTCCCCCGGATGTGAGGCAGCAGTTTCTCCAGAGCTGGGTTGTTCTCCAGGTGGCCCCTGCTTAGCCTTGCGCGATCATGGTGTTCTTGCCCTCAGCACCACGGCCTGTCAGATTCCCCCAAACGGCACGTGAACCTGAGTGCGGATACTGCAATTTTCAGAGGGAAGAATGGCAGCTCTTATGGGTGGGGGACGGGAACTGTCACTCATTTTGCACAACTTCTTAAGCGGCTGATCATTGAAAGCCATGTATCTTGCAGGGAGACGTGGCCATCCCTGTTGGGATCAACAGTGTCCAGAACTTGCCTCAAACTCAGGATCCAGGCTCTCCTTCCTCAACATTGGCAGATCATAGCCCAGGGAGCGAAGACAGGATTGAACTCCTGACTGGTTCAGCCGGCCAGACTTGTCTTGTCGAAGTGTTTGAACATCATGCTCCTCGTTCACCGCGCCCCTTCCAGCCCGCGACGCGCCGCGACCAGAAAAAACACGGCGGCCGCCCGACACAA	458	468	995	1005	10
2G5Z3:00154:05246	INITIAL_QUERY	AGAAAACTTTATTCATGAGGTGGCTTCTCTGTGTGAGGATTTGCAGTCTTCTCCCAGGGTCCCGGCTAGCTCTTTTCCATGAAGGCCAAAGAGTCAATAAGGCTGTCATACCAAGCAACTGACAAAGACAGTGGCTGGAAGGCCACTGTCCAAGGCCCAGTCCAAGAAGAGTACATGGTGGTGTGGGAGTTCTTGGTTCTTCAGCCACCTCTGTGAGTGAGCTTGGGTTCGTGGGTGTGAGTCTCTGTGTTAGACACTTTCAACAATGCTTAGCATTAATCCAAACTCTTCCCATTAGAATATAGTTTCTTCAACCCTCGCTCTCCTCCCAATCACGGCCTATCAAATAGTGGGTGTTACAGCTGAGGGCCAGACTCCACCCAGTGACAAAACCAGTAGAGTCCATGGACTGGGCTTTTGTCTTGTTTCTATTATCTGAAGGGCATCTTGGGCTACACTGAGGACCAGGTTGTCTCCTGCGACTTCAACAGCAACTCCCACTCTTCCACCTTCGATGCCGGGGCTGGCATTGCTCTCAATGACACCCGAATCTCAGTGAGGCCTCCTTGGTGAACACGAAGCCCACGTTCCCCCGGATGTGAGGCAGCAGTTTCTCCAGAGCTGGGTTGTTCTCCAGGTGGCCCCTGCTTAGCCTTGCGCGATCATGGTGTTCTTGCCCTCAGCACCACGGCCTGTCAGATTCCCCCAAACGGCACGTGAACCTGAGTGCGGATACTGCAATTTTCAGAGGGAAGAATGGCAGCTCTTATGGGTGGGGGACGGGAACTGTCACTCATTTTGCACAACTTCTTAAGCGGCTGATCATTGAAAGCCATGTATCTTGCAGGGAGACGTGGCCATCCCTGTTGGGATCAACAGTGTCCAGAACTTGCCTCAAACTCAGGATCCAGGCTCTCCTTCCTCAACATTGGCAGATCATAGCCCAGGGAGCGAAGACAGGATTGAACTCCTGACTGGTTCAGCCGGCCAGACTTGTCTTGTCGAAGTGTTTGAACATCATGCTCCTCGTTCACCGCGCCCCTTCCAGCCCGCGACGCGCCGCGACCAGAAAAAACACGGCGGCCGCCCGACACAA	106	116	1074	1064	-10
2S43D:07375:09082	INITIAL_QUERY	TTGGTCTACAAGACGCCACATCCCTATTATAGAAGAGCTAATAAATTTCCATGATCACACACTAATAATTGTTTCCTAATTAGCTCTTAGTCCTCTATACTCATCTCGCTAATATTAACAACAAAACTAACAACAATACAAGCACAATAAGATGCAACAAGAAGTGAAACATCATCTCCTGCCCCATACAACTGGACAACTGAGCCACACTGGGCAGGTCCTTCCCTGGGGCCAGGTTCCCTGTGTGAGTCCCCTGTCCTTCACCCTCTCTGCTGTATGGGTCACTAACTCGGACTCCAAGGAACAGAGCCACAGAGCATGTCCAAGCTGCTCTTCCTGTCATCCTTGCCCTCTGGCCAG	311	321	334	344	10
2S43D:07341:10836	INITIAL_QUERY	GGAGAGGAGAGGAGAGGAGAGGGGAGGGGCTAGCCTGGCTTGCAAGCCTTGGGAATGCTTTAGCATCTGTGTTATCACTGCAGACAAAGAGCTTCGGTGGATGAAGGTGGTGCAGGGAGCAGGGCACCCACCCCAAGTTCCAGAAGCCCAAGCAACTAGAAGGAACAAGGACCTGATTTTCTGGCCATTTATCCCCGCGTCCGAGATGCCGCCGCAGAAGCTGAGGTTGAGGAGCCGGAGGCCCGTCAGCCCTCGCGAGATGTGCTTCAGGGAAAGATCCGTGAGTTTCTGGCAGTCCTGAAGAGTGAGCTGCTCCAGGCA	103	113	204	214	10
2S43D:04517:14158	INITIAL_QUERY	TCTGCTTTCAGTTTGTCGTAAGACCCAGGCGTACTTGAAGGAGGCCTTTCCCATCTCCAGCACCTCTCTCAAACTTTTCGATGGTTTCGCTTGTCGATTTCCACCACATTTGTAGATCAGA	412	422	83	73	-10
2S43D:02690:09539	INITIAL_QUERY	TTAAGAACTAAAGTTGTGATGAATAATTGCTCCTGACTTGCAATGTTCTCTCTTCCTCCCTCGGCTTTATATTTTTAATTAGTTTTGAGTGTATAATATACTCATCTCAATTCTGGAGTTGAATATGATAAATTCCAAGATCTGTCTATGAGCCATGCTTTTGTAGGGGTGGTGCTATTTTCAGCATTCTGAGGACTGCTTATTTAATAACTGGGCCTTCTGGGCTCTCAAAGGGGTATCTCATCAGGATGAACGCATCTGACTTAAATCCTTGTACCCCATTCCAATGGGCCGATGGGCGTTTATTTTGATAAGATGTGCCTCTTGGAATAAGGGTAGTAGTTTATATCAATTATTTATTCAGATTTCGGACAATGACTTTAGTGACA	467	477	242	252	10
2S43D:06931:02277	INITIAL_QUERY	GCAAGATGCTGAGTCTCCTGAAACCCCTACCTATGAAAATTTCACCTGAAGGGAAAAGCGGCTGCTACTTCCGGGGTGAGGATTTGGAGAAAAACAGACATCATAAATCCTCCTGTTCTGCAGAAAGAACACAATCAGAAA	608	618	52	42	-10
2G5Z3:06899:14354	INITIAL_QUERY	GGCTGGAATCCTGTGGGAAGGGAAGGTGAGGGGGTCAGAGGCTCCTGGCTGGCAGTCAGGAACTCTTCTGCCGCTTGTGCGCTCTATGCTTGATTGGTGTGACTGTCTGCGCGTCTGCTGGCCTGTACTTGTGGGCAAGCTTAAGCAGCTGAGTAGCTGTCTGCCTGTCCAGGCCTGGGTGAACTGGTTAATGGCAGGAGGACTTGAGCCGCTTGTAGAGATAGCTCTTGTCGCTGCAGTCTGATGAGCGGGTCATTGACGAGCGCGTTAATCTCTTTGGGCTGGATCGAATTCCTAAGAGTCGAGGTGTGGGACCCACCGATCTGCCAGGGTGCCTTTGGAAATATGTGTCGTGGGGGACGCAATTGTTTGCACCAACCAAAACCTGGCGTCGTTGGCCACCCTGAAACTGAACCCCATGAGGGAAAGAGGAAAGTGGAATCTCTGTGGCCCATCTTCAGGATCCATCACCAGAAAACCCGCTATATCTTCGACCTCTTTTACAAGAGGAAAGCCATAAGCAGAGAACAGAGCAGAACTTATTACACAGAGCAGCACTTCTTACACAGAGCAGAACTTATTACACAGAGCAGAACTTATTACACAGAGCAGCATCTTCTTACACAGAAGCACTCGGTCTCAGGACAGCACCCTCTAGCCTGTTCACCGAACTTTGACTCCCAAATCAATGTGCCGAAAACCATGGAATTCATGGAACGTTTTCTCAGGTGACCATTGGTTTTATTCCAGGCATGGAAGTATTTGAATTTTCTAAAAAGTTAAACCAATGAAATCATATCGTATATGATGCTTAATTCATATATTCCTGCCGAGCGGCGGCAGTGACCGGTGGACGCTGACGGCGTGCGCGCGTCCGTCCGTCCGTCCAGCGGGGCGAGGGTCGGTGCACATACATCTTGACCGCGGCGGGTGAACATCTTGACCGCGGCGGCTCGTCCGTGTCTGCGTGGCGGGTGCGGGTCCTGCGGATGCGTGTGCCTGA	330	340	824	834	10
2G5Z3:10517:08189	INITIAL_QUERY	GGCTTGGGAATGCTGACTGTCCCCCCCCCCCCCCCCCCCCCCCGTGTACATTGCTATTTCTTTCTGCGTGCATAAATTGTATAGCATATTAGAAACTGGATTTGTAATTAAGCAGGTTCAAATGAATCTTCAGAGCATCATTGATGCTTGATCACATGTCTCGATCCCAGTAGACGGTCTTGGGCTCGGATCTACACTGAAAAGGTGTGGCCCGGAAAGAGTAATGGCATAACCGTCCACGTGGGCATCCACCCCAGCACGGTGGGGATCGGCAGGCTAAAGTGACAAAGACAGAAAAGAAAACCCAGCTGAAGACAGATGGGCTGACTCCTGTTGAGATGCAGAACCTGGAACCTGGCACCTGCTACCAGGTGTCTGGCCGCTGCCAGGTGGAGAACGGATATCCATGGGCGAGTGGAGTTCGCCCCTGTCCTTCCAGACGCCATTCTTAGACAGCCCGTGCACCTACGACGCCTGCAGGAGCAGAAGTGACGGGAGTGCCTGAGGGCCGGGACCAAGCCATCATCCTGAAGCCTCATGATTTCTGCCTTGGGATCTAGCAAAAGTATTCGTTTCTAAATGGCCAGTATTCTAGAGCCTCTCCCCAGAAGTTCGTTTTATTTGAGCACACTCCTTTCCCTTTCTGATCTGAAACCCTTCGCTGTTTATAAAACAGGATTCAAACCGTAACACACCCACCTAACCATATACATACTATAAATCCCA	468	478	521	511	-10
2G5Z3:00346:02410	INITIAL_QUERY	TGTCAACGTCAGCAAGGGAGTCAATCACTTACTGAAGAGCCCTTTCAGTGTTCATCCCAAGACAGGTCGGATTTCTGTGCCTATCGATTTTCATAAAGATGGATCAATTTGAATTCCGTTTCATACTGTCCCCAACTATAAGTGCCATCTGCCGACAGACATCCATGAAGACAAACACAAAGATACATACACACATGTACATACACACACATGCATGTAAAATAAACAAATTTTAAAATAAAAATAAAAGGGATCGTTTTAAAATAGGTGAGTGAAAGA	158	168	60	50	-10
2G5Z3:07290:13235	INITIAL_QUERY	CACGAGCATCATGGGTCACCAGGTGCGGGATTCCTTTTGTGCCTACAAAGATCTTTCTCACTTTGCACAACTTGTACTTGGCCTCCTCCGGTGTAATACGATGAACAGCAAAGCGACCCTTGGGTGTCATAGATCAGACGGAAGTTCTCTCCGGTCTTGTCAATGCTGATGACATCCATAAAACCCAGCAGGGTAGGTTATATCGGA	455	466	150	161	11
2G5Z3:07290:13235	INITIAL_QUERY	CACGAGCATCATGGGTCACCAGGTGCGGGATTCCTTTTGTGCCTACAAAGATCTTTCTCACTTTGCACAACTTGTACTTGGCCTCCTCCGGTGTAATACGATGAACAGCAAAGCGACCCTTGGGTGTCATAGATCAGACGGAAGTTCTCTCCGGTCTTGTCAATGCTGATGACATCCATAAAACCCAGCAGGGTAGGTTATATCGGA	562	572	9	-1	-10
2S43D:04651:01974	INITIAL_QUERY	GGGCTATCTTCCAGCTTCTTACCAGAACGACGATCGATCTTTTCTTTAAGCTCAGCAAACTTGCATGCTATGTGGGCTGTGTGCAATCCAGAACAGGAGCGTAGCCAGCACTGATTTGGCCTGGATGGTTCA	21	31	80	70	-10
2G5Z3:05864:06711	INITIAL_QUERY	GCCCTGGGGGTGGGGTGGGTGGGCGCCTGTGTCCTGGCTCCCCCTCCTGCAGGACGCCGTTCTCCACCTGGCAGCGGCCAGACACCTGGTAGCAGGTGCCAGGTTCCAGGTTCTGCATCTCAACAGGAGTCAGCCCATCTGTCTTCAGCTGGGGCTCCAGCCGGGTCCATGTTTCAGCCTGGCATTCCTTGTACCGGAACTGACAGATGAGAACTTTCTGCGGA	184	194	46	56	10
2S43D:02717:01041	INITIAL_QUERY	CCCCCCCCTTTTTTTTTGTTTTGTTTGTTTTTTCGATGACAGGGTTTCTCTGTATACTTGGCTGTCCTGGAACTCACTTTGTAGACCAGGCTGGCCTTGAACTCAGAAATCCTCAGCTTTTACAACCGTTTGCCAGTCGGCAGGAGTTAGTGCCATGCCAGCGAGCCTGTCTAACTGCACCAAGGTAAAATTAGCATTGGTTCCGTATTTACGAACCGACTCGGCAATTTCCTTAATTTGTAAGTATTCTACCGGAGCGTGGACACGCCCCACCCTCGGCTCCTTCA	329	339	136	126	-10
2S43D:06918:02833	INITIAL_QUERY	GGGGACCCAATTCTCTACCAGCATCTGTTCTGATTCTTTGGGCACCCAGAAGTTTATATTCTTATCCTCCCAGGATTTGGAATTATTTCACATGTAGTTACTTACTACTCCGGAAAAAAGAACCTTTCGGCTATATAGGAATAGTATGAGCAATAATGTCTATTGGCTTTCTAGGCTTTATTGTATGAGCCACA	141	151	114	104	-10
2S43D:04455:09560	INITIAL_QUERY	TGAAGATAATGGTATCATCAAGGCCTTCCGCAACATCCCTGGTATTACTCTGCTTAATGTAAGCAAGCTGAACATTTTGAAACTGGCTCCTGGTGGGCATGTGGGCCGTTTCTGCATCTGGACGGAGAGTGCTTTCCGGAAGTTGGATGAGCTGTATGGCACTTGGCGGAAGGCTGCTTCCCTCAAGAGTAACTATAACCTGCCCATGCACAAGAATGATGAACACCGACACTTAGCATCATAGCTGCTTCATAGCAACCTTCATTGAATGGCGAAACAATGAGCTCTTCTGTGCTGCGGGGGTAAATTAGAAGCAGTACCAAGAGTCAGCTTGCCCTTGTTGACGTCATGGAAGACAAACTCAAGGGCGAGATGATGGATCTCCAGCATGGCAGCCTCTTCCTAAAACACCAAAAATTGTCTCCAGCAAAGACTACTGTGATAACTGCGAACTCCAAGCTCGGT	394	404	197	207	10
2G5Z3:06953:12363	INITIAL_QUERY	GGAATGTGGGGTCAGCGGTCTGTCACTCTCCCTACACGCTGGCGGCCAGCCTCATCGAGTCAGGCATGAGCTGGAGCCAGGCGGTCGGCACGGTCTTTTTGGGCAACCTCATCGTGCTGCTGCCGATGCTGCTGATCGGCCATGCGGGA	2	12	133	143	10
2S43D:07878:10450	INITIAL_QUERY	CAGAAAGCGGCCATTTTCCACCATGATATTCGGCAGCAGGCATCGCCATGGGTCACGGACGAGATATCAATAGTAGAACAGAGCAGGAACAGGATGAACAGTCTACCCACCTCTAGCCGGAAATCTAGCCCATGCAGGACGCTATCAGTAGAACCTAAACAATTTTCTCCCTTTCATTTAGCCACATCCATGGACTGTACGTAGTCCTCAAAAGCAGTAATTTGCTCTTCCAGCATTATCCGATTCCAACCTTATCATCTTCAACTACACATGTATTTGAAGCTTTTAATTCCATATCCACTGGAACCAATTTAGAGGAGCCCCACACCGAGGCCATCTGCTTGATGCTTCGGACACACTCCTCTAGTTTTGTCA	561	571	47	37	-10
2S43D:01117:10077	INITIAL_QUERY	CAACCGTGCACGCCCAGATGCCGAGAAAAAAAGAAATGAAAACAATCACGGGGAAGACTTTTTCATCCCGCTAACTCTTGGGAACTGAGGAGGAAGCGCTGTCGACCGAAGGCTGGACTGCAGGGAAGTGGAAGGAGTGTGGACTGGGACCCTGCTTGCTGCACCTGGGAAGGCACACCAGTAAGAGATGGCTCCTCAGAATGTCCTTAGCTATGTCTATCCCATGGACCCCAACTCCAAGGGGCTGAGGGGAGAGGGGAGAACTAGAAGAGAACTAGGGAAACTA	333	343	18	28	10
2G5Z3:09769:05273	INITIAL_QUERY	CGGTAGCATTGTTTGGAGGATCTCTGATCTATCAGAGCACAGGACGGGCAGCGAGGCACAACGCCCAGCACCAGAGATCGCGCCAGAGCCCGAGGCCCGGCGCCGGCCCCTAGGTGGCGATGCGGCCGGGCGCTCGGGAGCGGGCCTAGAGCAGGAGGCCGCGGCTGGCGCCGAAGACGACGAGGAGGAGGAGGGCATCGCCGCTCTGGACGGCGACCAGATGGAGCTGGGCGAGGAGAACGGGA	502	512	161	151	-10
2S43D:01083:05400	INITIAL_QUERY	CAGGGGCTCGCGCCAGCCGAACTGTTCGCCAGGCTCAAGGCGCGCATGCCCGACGGCGATGATCTCGTCGTGACCCATGCGATGCCTGCTTGCCGAATATCATGGATGGCGTTGGACAGCATAGAACACAACACGTGGGACCTAACTTGCAAGGATTGGGTCTTCAACTTCAAGTGCAATGTGTATGAAAACCAATCTGAGCCTTTGTATTCTCGTAAATATTTATTTTGTAATTTTTGTGAAAATCCGGGGGAGAGGGTGTAAATCTCGCGCCGGGCCGTACCCTTATCCGCAGCAGGTCTCCAAGGTGAACAGCCTCTGGCATGTTGGAACAATGTAGGTAAGGGAAGTCGGCAAGCCGGATCCGTAACTTCGGGATAAGGATTGGCTCTAAGGGCTGGGTCGGTCGGGCTGGGGCGCGAAGCGGGACCAGATGCCAGTGCTCGCACGGCACAAACTCTGACCATTGAGCGCCCGGGGTGTGGAGAGTTGAGGATGGGAGGTGAGTCAAGGTACTAAAACACTCTTCTAAACACTTTACAAACCTTTTGAAAAACCCATAGAAATCTAAAAAAAAAAGGTACAATAAGAAGCCAAAATAGGTTCCCTAAAACATGTCCTTCCTTCCTTCTTCCTTCCTTTCTTCCTTTTCTTCCTTCCTTCTTCTCC	493	572	0	79	79
2G5Z3:09400:06514	INITIAL_QUERY	GTGAAGTTCGTGACCTCAAACCCAATGGAGCCAACATCTTGGTAACAGAGGAGAACAAAGAAGGAATATGTACACCTGGTTTGCCAGATGAGAATGACAGGAGCCATCCGCAAACAGCTGGCAGCCTTCTTGGAGGCTTCTATGAAATCTTCCAAAGCGCCTCATCATCCATCTTTACTGAGCAGGAAATTAGCTGCTCATATCAGGA	310	320	93	83	-10
2S43D:01858:03544	INITIAL_QUERY	GCGTCGGGGTCGGGGCGACGCCGGCCTCGCGGGCCGCCGGTGAAATACCACTACTCTCATCGTTTTTTCACTGACCCGGTGAGGCGGGGGGGCGAGCCCCGAGGGGCTCTCGCTTCTGGCGCAGAACTGAGATCACTCATGCTGTTGTCATCAAGAAACTGAATGAGATTCTACAGGTCAGAGGCAAGAAGGGAACAGACCGTGCCACTCAGATTGAATTGCTCCAGCTGACTGGTTCAGATTGGCTGCTGAAAATCGAACCTGGGGGTGGGCGTTCATTGTCAAGACCCGTGGCGCCGGCAAGATGGGCAAGTTGTCGTGTCTCCGAACTGCCCGGAGCTCCGCAGTCACCGACGGGAC	149	160	278	289	11
2G5Z3:02743:01274	INITIAL_QUERY	CTCGATAATCAAACAGCCTGTAGATGGCAGTTGCTGCTCTCTTTACGCCCTTGGGTCTATTAGGCTTGGGCTCTCCAGCCATGTTGATGCCAGGGTCTGTCCAGCCAGCACCCCGCCCATTCCTCTCCCGAGCACAGCTGCCCGGGCACTGGCTGTGTGTCCAATGGGCCTCTCTTTCCAGTGATGGCCGACTAGGCCATCTTTTGATACATATGTAGCTAGAGTCAAGAGCTCCAGGGTACTGGTTAGTTCATAATGTTGTTGA	238	248	131	121	-10
2G5Z3:09682:12716	INITIAL_QUERY	GTGGGAGCACCTGGAGCGCAGAGCTCGGAAGGAGAATCCAACGAGTTGTAAGAAAATGGACAGACGAAGTCCCGGTACAATGGGGGAAAACTCGCCAGCGGGGAGAGACATGTTATAAAACATTGAGAGATATGACTGGGAGAGGGTTCCTGGATTCCTGTACTCATTAGCTGCTTTCAAAGTCGTCACAGTTTATCTTGGGAGTTCTCAAGTGCTGCCCCGCCCATAAAGATAAGATTAACCCGTGGGCCCCCCTGATAGTCCTGGGGATCTTAATAAGGGCAGGAGTATCAGTACCACATGACAGCCCTCATCAGTCTTCATGTACTTGGAGAGTTACCAACTTAATGACGGACAAACAGCTAATGCTACCTCCTCGGGGGGTTGGTTCTTTTTCAAGACAGGGTTTCTCTGTGTAGCCCTGGCTGGACTAGAACTCCCTTTGTAGAATAGCCTGGCCTCAAAATCACAGAGATCCACCAGCCTCTGCTTCCTA	70	80	130	140	10
2G5Z3:08013:07637	INITIAL_QUERY	GATGGTGTCACTGGGCTCCACCTCCAAGGTGATGGTCTTGCCGGTCAGGGTCTTCACGAAGATCTGCATGCCACCTCTCAGGCGAAGGACCAGGTGCAGGGTTGACTCCTCTGGATGTTGTAATCAGAGAGGGTGCGGCCATCTTCCAGCTGCTTGCCGGCAAGATCAGCCTCTGC	579	589	149	159	10
2G5Z3:07537:06292	INITIAL_QUERY	TCTTGGTTTGCTGGGCCCCAGACTGCTGGGCCTGGGATTGCAAGAGCTGAGCGCCGCCATGCTTTTCTAGGAAGTTACGTCACCTCTCCTCAAGCGGCCGCTGCGGTGAGCCTTGAAGCCTAGGGCGCGGGCCCGGGTGGAGCCGCCGCAGGTGCAGATCTTGGTGGTAGTAGCAAATATTCAAACGAGAACTTTGAAGGCCGAAGTGGAA	41	51	90	80	-10
2G5Z3:02874:02009	INITIAL_QUERY	CAATGGTTGAGTCTCAATGGTGTCACCTTCCAGGATCATCACAGCCCTAATTTTAATATGAACTCAAACAACATATTTAAATTAGTTATTTTTCCATTCCCTCCTCCCTCGTCCAGCACCCCAATGCGAACAAGCCGCCGCAGGAGAGCATTGCCTCAAACAGACGCCGGGGATCCTCTCGTCTAGCGATCAACAGCGTCCCGGGCCGCCTTACGGATCTTGGCCAGGGTAAACTTGACCCTCCAAAGGCCAGCTTATTCTTCATGTCCTTGGCTATGTTTTTGCTCTTTCTCTTCCGGGAAGCTTCATCACATTCTGTGAGGTCAGTCCCACTCATCTTCTGTGTCCCGTGAAGAACAGGGAAAGGTGGTGCATGGAGCCTCCATTACGACCCAGTTCTTTTTGAGGTGCG	142	152	395	405	10
2G5Z3:02874:02009	INITIAL_QUERY	CAATGGTTGAGTCTCAATGGTGTCACCTTCCAGGATCATCACAGCCCTAATTTTAATATGAACTCAAACAACATATTTAAATTAGTTATTTTTCCATTCCCTCCTCCCTCGTCCAGCACCCCAATGCGAACAAGCCGCCGCAGGAGAGCATTGCCTCAAACAGACGCCGGGGATCCTCTCGTCTAGCGATCAACAGCGTCCCGGGCCGCCTTACGGATCTTGGCCAGGGTAAACTTGACCCTCCAAAGGCCAGCTTATTCTTCATGTCCTTGGCTATGTTTTTGCTCTTTCTCTTCCGGGAAGCTTCATCACATTCTGTGAGGTCAGTCCCACTCATCTTCTGTGTCCCGTGAAGAACAGGGAAAGGTGGTGCATGGAGCCTCCATTACGACCCAGTTCTTTTTGAGGTGCG	365	375	132	122	-10
2S43D:07836:13359	INITIAL_QUERY	GAAACATTAAACAACAAAATTAATATATTACAAAAAGAAAAAAAAAAGAAAGTGTTCAAATAACCACTAAGTTATCAAAAGAAAATTGGCCAAATCAAAA	143	153	29	19	-10
2S43D:01114:13859	INITIAL_QUERY	GGCAGATTTCTGAGTTCGAGGCCAACCTGGTCTACAAATTGAGTTCCAGGACAGCCAGGGCTACAGAGAAAACCCTGTCTCGGAAAAAAAAACAAAAAAAAAAGAAAAAAGGGGGGGGGGACCTCGGTCCCCGGCGCGCGCCTCCACCGGTTCCCGAGACTTCCAGCGCGCTCCGAGGGGCCACTTTTCCTCTAGTCTCGAAAACTGCCCTCATGGCGGAGGTGAAGGTCAAGGTGCAGCCGCCGGACGCGGATCCGGTGGAGATAGAAAACAGAATTATAGAATTAATGCAGGTGTTTCTTCCTCTGAGCTGGAGTCCGAATCCGAGTCTGAGTCCGACTCAGAGCTCTCTGCCTTCTTCGCAGGAGGTCTGACTGCCTTGGCTTGGGGCTTGAGCTGCCTTCTGGACAGGCTTTTTCTTTTTGA	367	377	235	225	-10
2G5Z3:08013:13527	INITIAL_QUERY	CAGGGGGGAGACGGGTCCAGTTGAGCTTGTCCAGGCTGTCACCATCTTGAGCCCGTCCACCACATACTCCAACGGTTTCCTGGTCCCTTGTTTCCAGGTCACCTTTATCATGTCGCAAGCTGCACTTCAGACGAATTATCAATAAGCACACTGATGAATCTTTAGGTGACTGCTCTTTCCTTAACACATGTTTCCACATGGACACCTGCAAATATGTTCACTATGAAATTGATGCTTGTGTTGATTCTGAGAGTCCTGGCAGCAAGGAGATTTACAGCAGAGCCCACTGGGTGGGCAGTGCCTTGGTTACAGAGCGGCCTGAGTGCTCTCCTCAGAGCCTTCTTCCCTGTCTTCCTGCCCTCTCTGTATTTCCCACAGTTCAGGACAATGCAGGTTTGGGCTTTCAGGCTGTCTAGTTCCAGGCATCGCCTGTCCTGTCCTGGTTCTTAACTTTTCTCCCA	571	581	420	410	-10
2G5Z3:05618:01823	INITIAL_QUERY	GCTTGGTGGTCGAATGGGCAGGTAGCCGGATCAAGCGTATGCAGCCGCCGCATTGCATCAGCCATGATGGATACTTTCTCGGCAGGAGCAAGGTGAGATGACAGGAGATCCTGCCCCGGCACTTCGCCCAATAGCAGCCAGTCCCTTCCCGCTTCAGTGACAACGTCGAGCACAGCTGA	239	249	168	158	-10
2G5Z3:02684:00861	INITIAL_QUERY	CGCGGCAGCCGCAGCCATGAGCAGCAAAGTCTCACGCGACACCCTGTACGAGGCGGTGCGGGAAGTCCTGCACGGGAACCAGCGCAAGCGCCGCAAGTTTCTGGAGACGGTGGGAGCGCAGATCAGCCTGAAGAACTACGACCCTCAGAAGGACAACTTCGTCGGGACCGTCAGGCTCAAGTCCACCCCACGCCA	522	532	171	181	10
2G5Z3:07153:08668	INITIAL_QUERY	GCATACACGGTACATGGGACCCACAAAATTTTTATCAGGTAAAACGATATTCCGGAGACCAGAAAGGACGCCAGTAGTGACCCATGGGGTAGGCAAGACCAACAACAACCAGATAGGCCATTTTAATAAGGGGTAAACGGGGACAGCGGTCTAGTTTTGGCTCATCCAGCTGACGCTGCAGCTTCTCCTGCTCCTTCATGTAGCCGCTCCTCTACTTCTTCCTTTCCCTAAGCAGTCTGTGCTCAACAGCCTTCGACCCTCCAAAGATCGGGCTACACACACACACACACAACACACACAACACACTTAACTTTTCTAAAACTGGCTTGGTGAGGGCTGGAAGAGAGGCTCTGAGCTTAGCCAGAATGAAGTTGGGGTCTCTCCAGTGTAGGCTGTCTTCGAAAAACATAGAGCAAAAACATTGGATGGGAAATAAAGGAACCAAAACAAATAGAAACGTTGTTGAGTTTCAGTGAAAATACTTAAACACATGCAAGGTCCTGACGGTTAGCCTTGGCCTTGGCAGGGGCTGCAGGTAGCCCTGGAGTTGGGACAGTATCTTAACTCAAGGCACT	562	573	76	87	11
2G5Z3:07153:08668	INITIAL_QUERY	GCATACACGGTACATGGGACCCACAAAATTTTTATCAGGTAAAACGATATTCCGGAGACCAGAAAGGACGCCAGTAGTGACCCATGGGGTAGGCAAGACCAACAACAACCAGATAGGCCATTTTAATAAGGGGTAAACGGGGACAGCGGTCTAGTTTTGGCTCATCCAGCTGACGCTGCAGCTTCTCCTGCTCCTTCATGTAGCCGCTCCTCTACTTCTTCCTTTCCCTAAGCAGTCTGTGCTCAACAGCCTTCGACCCTCCAAAGATCGGGCTACACACACACACACACAACACACACAACACACTTAACTTTTCTAAAACTGGCTTGGTGAGGGCTGGAAGAGAGGCTCTGAGCTTAGCCAGAATGAAGTTGGGGTCTCTCCAGTGTAGGCTGTCTTCGAAAAACATAGAGCAAAAACATTGGATGGGAAATAAAGGAACCAAAACAAATAGAAACGTTGTTGAGTTTCAGTGAAAATACTTAAACACATGCAAGGTCCTGACGGTTAGCCTTGGCCTTGGCAGGGGCTGCAGGTAGCCCTGGAGTTGGGACAGTATCTTAACTCAAGGCACT	390	400	531	521	-10
2G5Z3:01458:04955	INITIAL_QUERY	GGCGTCTGGAAGGACAGGGGCGAACTCCACTCGCCCCATGGATATCCGTTCTCCACCTGGCAGCGGCCAGACACCTGGTAGCAGGTGCCAGGTTCCAGGTTCTGCATCTCAACAGGAGTCAGCCCATCTGTCTTCAGCTGGGGCTCCAGCCGGGTCCATGTTTCAGCCTGGCATTCCTTGTACCGGAACTGACAGATGAGAACTTTCTGCGGTGGCCACACGGGCGGCGCCCACGTGCACAGTCGGCCATGGGCATCGAGCGGACGATGATCGGCTCAACAAGGTCATCAGTGAGCTGAATGGAAAAGAACATTGAGGATGTCATCGCTCAGGGTGTTGGCAAGCTGGCCAGTGTGCCTGCTGGTGGGGCTGTGGCTGTTTCTGCTGCCCCTGGCTCTGCAGCACCTGCTGCTGGTTCTGCCCCCGCTGCAGCAGA	425	435	252	262	10
2G5Z3:06237:14085	INITIAL_QUERY	CGACTGTGCACATGTGTAGCCAGGTAGTCTCGCAGCAGGGCCATGATGCGGCCCACAGCAGCTGGCTGTCCCAAACACAAGAACGCTGCAGCCGCCTTCTCCAGCCCGTCGAGGTCGTAACGTTGTGC	368	378	86	76	-10
2S43D:00629:02751	INITIAL_QUERY	TGCAGAGTCGTGTTAACTAACCCCCACTCATTTGAGCCGTGAGCCCATTAGTCTTTGTTCACGGAAGTGAAAGCACCTGACCCTGCATCAGGCAGTGCTGGCTTGGGTTTTTGGCTTTTATTGTGAAACAGCCAGCCTGTGAGGAGCGCTTCCCCACAGCTCAGCATTCCCAGGCCTGACGCACTCCTGCTCCTGCCTGTAGATTTATGCTGGGAGAAGACACCTTGCCCCTCTCTCGGGTCAGGCTGAACTCATGCTGGATGGAGTTATCCTTGGTGTTATTCTCATGGCGGCAGTCCAGGCGAAGGTTTTGGTTCACCAGGCAGGCTGTCAGGCA	327	337	187	197	10
2G5Z3:06008:02552	INITIAL_QUERY	TCCAGGTTCTGCATCTCAACAGGAGTCAGCCCATCTGTCTTCAGCTGGGGCTCCAGCCGGGGTCCATGCATTTCAGCCTGGCATTCCTTGTACCGGAACTGACAGATGAGAACTTCTGCGGTGGCCACACTGGGCGGCGCCCACTTGCACAGTGGCAAGCAGGCATCTGAGGGCCCACTGAAGGGCATCTTGGGCTACACTGAGGACCAGGTTGTCTCCTGCGACTTCAACAGCAACTCCACTCTTCCAC	574	584	157	147	-10
2S43D:01848:08640	INITIAL_QUERY	GGCTCGCGCCAGCCGAACTGTTCGCCAGGCTCAAGCGCGCATGCCGACGGCGATGATCTCGTCGTGACCCATGGCGATGCCTGCTTGCCGAATATCATGA	542	598	43	99	56
2G5Z3:03114:07033	INITIAL_QUERY	CTCCTACCTATACATTATCCACAAGCAGGCACCTCCCCTGGAAGACATCGCTGGTGACTGCAGTCCAGGCATGAGGGAGCTGATAGAAGCTGCCCTGGAGAGGAACCCACCACCGCCCAAAGGTTTTCTATGAAACCTACTTGGATCCCATGCCTGGAATTTGGAAGCATATGTACAAAAATCATTTTTACGTTTTATTTTTATAAATCATTGTTGTTTAGACCGTAAAAAAAAAATAAAAAAAAGGGAACATAAATCAAGCCCTACTAATTACCATTATACTAGGACTTACTTCACCATCCTCCAGCTTCAGAATACTTGAAACATCATTCTCCATTTCAGATGGTATCTATGGTTCTACATTCTTCATGGCTACTGGATTCCATGGACTCCAT	576	586	21	11	-10
2S43D:08833:04646	INITIAL_QUERY	CAGGAAATGAGCTTGACAAAGTTGTCATTGAGAGCAATGCCAGCCCCGGCATCGAAGGTGGAAGAGTGGGAGTTGCTGTTGAAGTCGCAGGAGACAACCTGGTCCTCAGTGTAGCCCAAGATGCCCTTCAGTGGGCCCTCAGATGCCTGCTTCACCACA	574	585	141	152	11
2S43D:08998:13902	INITIAL_QUERY	CGAATAGCCTCTCCACCCAAGCGGCCGGAGAACCTGCGTGCAATCCATCTTGTTCAATGGCCGATCCCATATTGGCTGCAGGTCGAAAGGCCA	0	10	58	48	-10
2S43D:04248:03729	INITIAL_QUERY	GGGCTGGAGAACTCACGGAGGATGAGGTGGAGCGAGTGATCACCATCATGCAGAACCCACGACAGTACAAGATCCCAGACTGGTTCCTGAACAGACAGAAGGATGTGAAGGATGGGAAGTACAGCCAGGTTCTGGCCAACGGTCTAGACAACAAGCTGCGTGAGGACCTGGAGAGGCTGAAGAAAATTCGAGCCATAGAGCTGCGCGTCATTTCATAGCACGAACAAAGGCAGGGCAGTAAAAAGCAAAGACGGAAGAGGCAGCATCTCCAGGGAAAGAACAGCCTAGGTCTCAAGCCACCCAACCTTCTCTCAAAGGTCACTTGCTAGTTTCAGCCAGTGTAGCGTGGGTACTGTGCATGACCACATTTATGTATGGAATCACACAGACCAGAAAGAGGATTCTCCACTGTAGACAGTTCTGACACACCGGCCTCACCCCATTGATGTTAGTGGGGTCTCGCTCCTGGAAGATGGTGATGGGCTTCCCGTTGATGACAAGCTTCCCATTCTCGGCCTTGACTGTGCCGTTGAATTT	53	63	168	178	10
2G5Z3:06548:02506	INITIAL_QUERY	AGACATCATGCTGGCCACGGGCAAGCTGTCCCCTGATGCCATTCCAGGTAAATGGGCCAGCCGAGACTGCCAGTGCTGGCGG	213	223	9	19	10
2G5Z3:06548:02506	INITIAL_QUERY	AGACATCATGCTGGCCACGGGCAAGCTGTCCCCTGATGCCATTCCAGGTAAATGGGCCAGCCGAGACTGCCAGTGCTGGCGG	489	499	29	19	-10
2S43D:08936:09871	INITIAL_QUERY	GGGGCACAGGAGGTCCTCAAGGGTATGAATAGTGTTACTTCATTCAGAGTGTTACTTTGTTTCTCTCCCAATCGTTTGGAGACCCTGCAACATTTACCTAACATTACCAAAGCCTGTCAAATCAATTCTTCAGTTCAAATTTTTGTATCCAATCACAACGGGGAGCATGGGGCCTGCTAATCAGAGTCTGAAAGCACGATGATCTCCTCCGGGTCGCACTGTGTGGCCACACTGGTCTTATAAATACACTGCCGGAGTCTCGAGGAAGGGGACACCCAGAGAGTCTGACAAATTCCTTGGCCGTGGTGTTGTCCACGACCTTCTTGGTGGTGAGGTCACTCTTGTTGCCTACCAGGAGTTTATTGACATTCTCACTGGCGTAGCGATCTATCTCCTGCAGCCATCTGTTTTCACGTTTGGCGTACGGAACTCCCTGGTCAGTGACGTCATACACACAATGATGCATGAGCCCCGCGATATAGCTGGAAGTGATGAAACATACTCCAACGGTTTCCTGGTCCCTTGTTTCCAGGTCACCTTTATCCCTGGGCTCCCATCAGCACTGCTCACTCCCACGTCACAGGGGGCAGATTCTGGAGCCAAGCACACCAGAGACAGGTTGGTGGGAGGCACCCAGCTGGTGCTGTTGCCAGGAGAGACAGCCATTCTTATTCTACTGAGACTGCCAAGGCACACAGGGGATAG	549	559	196	206	10
2S43D:06718:03366	INITIAL_QUERY	GGCGGCTCTAGGCTCCAGCAGCCAGAATGTCACCGAGTACGTCGTCCGCAGTCCCCAAGAACACAGCCAAAAGATACAACATAATGGCTTTTAATGCAGCCGATAAGTCAACTTTGCTACCTGGAACCAGGCACGGCTGGAGCGAGATCTGAGCACA	438	448	32	22	-10
2S43D:07032:04848	INITIAL_QUERY	ACCACCGCCGTGTCCCGGCCCGGCCTCGGGGAGCCCGGTTCATCATTGTCGGCTACGTGGACGACACGCAGTTCGTGCGCTTCGACAGCGAACGGCGGAAAATCCGAAGGAGTGGAGCCTTCGGGGCGCGGCGCACTACTTGTAAAAGCCAAGGACAGGATCTCCCTAAGGATCCAAGTACCCATGTTTGAAGTATACTTTCTTCTAGTTGACCAGCCTGGGCAAAGCAGGACTGAGGTAGCTTACACCAGCCTTTTTAGACAACCTTGTTTAGC	304	314	155	165	10
2G5Z3:02261:05632	INITIAL_QUERY	GTTGTTTTGAGACAGTTTTCACTCTGTGGCCCTGCTTGCCTCTGCCTCCCAAGTGCTGGGGAATTAAAAGGTCATTAACCCTACCACCGCAAAAAAACCTTGATTCGATGCTAGAAGTAACTTGATCAATGAG	578	588	30	40	10
2S43D:06610:10394	INITIAL_QUERY	TTATAATGCCAGCCAGCAGCCAGTAATCCACTGGCGACGGGTGCCAGATCTCGTAAGTTCTCCCAAGGCTTACACAGAAAGTAGAGGGGCAGATAGATGGTAGCAGATGGGGTAAGAATCAGAAGATTAAAAGAATATTTCTTGTAACTATAGAAAGAATATGTATGTATATATATATATATGGAGATATATATGCAGATATACATATATACAGGA	275	285	14	4	-10
2G5Z3:05353:05408	INITIAL_QUERY	GTAGGATGCATTGCTGACAATCTTGAGTGAGTTGTCATATTTCTCGTGGTTCACACCCATCACAAACATGGGGGCATCGGCAGAAGGGGCGGAGATGGATGACCCTTTTGGCTCCACCCCTTCAAGTGGGCCCCGGCCTTCTCCATGGTGGTGAAGACACCAGTAGACTCCACGACATACTCACACCGGCCACCGCTATCTATCCTCTCCACAATGCCTGCTCGCCTCCTCCGCGCAGTTGACAAGCCAAGCCGCCAGCTAGCTTCATCACCAACTCGCTCTCGCTCCACCATCTGGAACCCTTTCCCACGCTTCACCACCACTCCTAGCAGAAAATCCTGCAGGACTACAAATCTCTCCAGGACATCATTGCCACTCGTTGGTATGGATACTTTCTGAGGAAGAATAAATTGACTGTGTCCCCGGGCAAGAAAGATACAGCGCTTCTTGTCTCAGATTTATTTGGCAATCAAACTCTGACCTCCCTCCCACCCACTCAACTAGGGACCCGATAGGAGCAGTCTCTTGAGTTCTCCCTGCACAAGGCAGGGAGAACAGAGACTCTTGCCAGCCTCCTCACCCATGCAATATCTCCAAAATGATCTAATACTCTTCGTCATCTGACTAAAGATTAGTACATCTTGAACCCTTGTTCTGTGGATGAAACCAGCGCCGAAGATGAGGGCATCTCTCAGAGGAAGTTTCTGGACGGCAATGAGCTCACCCTGCTGACTGCAACCTGCTGCCAAGCTCACATAGTACAGGTGGTGTGCAAAAAGTACAGAGGCTTCAGCCAATCCCAGCAATGGGTTTCCACCAGATGTTTCTATTAAAGAACATCAAACGATGCTTGGGTTTGCACCAATTGACATGTTCAGGCTTTGCCCTGCACAACTTCGGCTGAACCTCCTCCTGGCCACAGTCACGCTGTTTCCTCCTCCCTCTTCCAATCCTAGA	338	348	387	377	-10
2S43D:09404:12773	INITIAL_QUERY	TCTCACTAGCCCTTGTCAAGACTTTGGCAAACGGATGTTCAGTGTTAAAAATCACTACAATACCAAACAGCAGGACCAACTTCTTCCAGGCAGCCCTTCCTGGAGGAGAGAGAC	149	159	12	22	10
2S43D:10493:10303	INITIAL_QUERY	GTCCATACCTAATTATTAATGTGCATTAAAATCAGCATAGAGCTGTTTTGAATTTTAACCATAATGAAAACCCAGGACTCCTAATTTCGTCAAATGTGTTTACAAGCAATAATAAAATTCAGACCCACTGTATTATGCCATATCTGAAGATACCAACCCTCGTATTCCATTGATCCAAGACATGAGGTCCCCGGAAATCGCTAAGGAAGCGCTGCAGATCATGGGGAGTCACCCAATTTGGCCCTGCGCTGGTCTGCACGCTTCCCTAGCTGGTCAGCCTGGTTTAACTCTGTGCACCTTTTCCTTTAAGTCCTCTGTCAGATTCAGGGTGGGATGGA	125	135	241	231	-10
2G5Z3:02355:05081	INITIAL_QUERY	CTTATCTCTCTGCTCCAGCCGGAATCCCAGCATTAAGGAATTCCACTCATACCTCATTTATTCCCATTTGACCTCAGCACCAGTATTTCACCCAGGCATCTTCCTATGGGCATGAGGAATGGGGGTTCTAAAACATAGACCCCAACAACTGGATATTTAATCTCAGGAGAGTCCTCGAGAATGGAGAACTCTGAACAGAACAGTGACCTGGAGTAAGGAGTGGGGGGTGTGGGCGCAGCTCTGGAGCATCATCCTGCCGGACATCCACAGTCGATGAATCCAGAAAAGCGGCCATTTTCCACCATGATATTCGGCAAGCAGGCATCGCCATGGGTCACGACGAGACAATTTTGGGGTGTGATGTTGGCAATGCAGCTTCTGGAAACGGGGCAATCTGGCAGCTGTCCTGATAGCCAGGGTAGTGGGGTTCAGGGTGGCCAACCCTGCAGGGAGGCTGCACACCTGCCTCTTGCACTGTGGCTCCTGCAAAGACATCACCTTGGGCTGGGCTCTCAA	555	565	335	325	-10
2G5Z3:06661:06658	INITIAL_QUERY	CCTGTTCAATGGTCTCTTTGGTCGGCAGGGTGTTCTTCTCCTGCGTCTCGGTTTTCTTCAGCTTGGCCTTATCGAAGCTGGCGATTTCCCCCATGTCCGGA	8	18	2	-8	-10
2G5Z3:06282:08172	INITIAL_QUERY	TGCTTTTGAGACAGTGTATCCTCTGTAGCCCAGGGCAGCCCAAACTTCTAGCTATCTGGAAAAGACCTTGAACTTCCTTCTGCTCCTTCAGTCTCTCCCTCCTGAAGCTAGAATTCAGGTGTGAGCCATCATCAGATCTTATCTCATGCTAGAGAAGTCGCGTCATACGTTCTAACTGAAAGGCTTTTTCTGGGGAAAGGTAACTCGGGCCCACGGAAACAGCGGTATGGTTCGTGCCAAATTCCGAAGCAACCTTCCTGCAAAGGCCATTGGACACAGAATCCGTGTGATGCTGTACCCATCCCGGATTTAAACTAATGGAGAGACGGAGACAGACTGACCCGGGCAGCCAAGGTGTTGGAGCAGCTCACAGGCCAGACCCCGGTGTTCTCCAAAGCTAGATACACTGTCAGGTCCTTTGGCATCCGGAGAAATGAGAAGATTGCTGTTCACTGCACAGTCCGCGGACCAAGGCAGAGAGGTGGCTATTTTGTGCCTGCAGTTCCGCAGGCTCAGGGAAGACCCCCATATTACACGCCTAACCAGTTAGCACAGATGAGCCTAATCCACGCTGGCAGCAAGGCGGGAGACCTCAAGGCTTCCAAGGAATGCCAGGGTATCTGGGAGCATGAAAACAAAGGACTGGTAGTCAAGTCCTGTGATCAAGCTGTCAGTCTATCGCTCTGCAGGACGACAGCTTCTGTCACTGTTCTCATCTGACCTGCAGCACGGGCCACTCCAAGTGGGTTTCCCAGCCCGGCTTCCATGGGCGCGTAAAAGCAGAGTGTGCTTACTTGGTTGGGAAGCTGGCTAGCGGGCTCATCCAGAGATTGGAGACAAATTCAGCAGTCGCCATGGACAAAAGGGTGTCTGTGGCCTGATCGTCCCCCCAGGAAGACATGCCGTTCTAGTGATTCTGGCATCTGTCCCGACATCATAATGAACCCACACGGCTTCCCATCAAGAATGACGGTTGGAAAGTTTAATTGAGCTGCTGGCTGGGCAAGGCAGGCGTGTTTAGACGGCAGGTCCACTACGGCACTGCCTTTGAAA	184	195	683	694	11
2G5Z3:06282:08172	INITIAL_QUERY	TGCTTTTGAGACAGTGTATCCTCTGTAGCCCAGGGCAGCCCAAACTTCTAGCTATCTGGAAAAGACCTTGAACTTCCTTCTGCTCCTTCAGTCTCTCCCTCCTGAAGCTAGAATTCAGGTGTGAGCCATCATCAGATCTTATCTCATGCTAGAGAAGTCGCGTCATACGTTCTAACTGAAAGGCTTTTTCTGGGGAAAGGTAACTCGGGCCCACGGAAACAGCGGTATGGTTCGTGCCAAATTCCGAAGCAACCTTCCTGCAAAGGCCATTGGACACAGAATCCGTGTGATGCTGTACCCATCCCGGATTTAAACTAATGGAGAGACGGAGACAGACTGACCCGGGCAGCCAAGGTGTTGGAGCAGCTCACAGGCCAGACCCCGGTGTTCTCCAAAGCTAGATACACTGTCAGGTCCTTTGGCATCCGGAGAAATGAGAAGATTGCTGTTCACTGCACAGTCCGCGGACCAAGGCAGAGAGGTGGCTATTTTGTGCCTGCAGTTCCGCAGGCTCAGGGAAGACCCCCATATTACACGCCTAACCAGTTAGCACAGATGAGCCTAATCCACGCTGGCAGCAAGGCGGGAGACCTCAAGGCTTCCAAGGAATGCCAGGGTATCTGGGAGCATGAAAACAAAGGACTGGTAGTCAAGTCCTGTGATCAAGCTGTCAGTCTATCGCTCTGCAGGACGACAGCTTCTGTCACTGTTCTCATCTGACCTGCAGCACGGGCCACTCCAAGTGGGTTTCCCAGCCCGGCTTCCATGGGCGCGTAAAAGCAGAGTGTGCTTACTTGGTTGGGAAGCTGGCTAGCGGGCTCATCCAGAGATTGGAGACAAATTCAGCAGTCGCCATGGACAAAAGGGTGTCTGTGGCCTGATCGTCCCCCCAGGAAGACATGCCGTTCTAGTGATTCTGGCATCTGTCCCGACATCATAATGAACCCACACGGCTTCCCATCAAGAATGACGGTTGGAAAGTTTAATTGAGCTGCTGGCTGGGCAAGGCAGGCGTGTTTAGACGGCAGGTCCACTACGGCACTGCCTTTGAAA	181	191	495	485	-10
2G5Z3:09572:02175	INITIAL_QUERY	CTCCAAAGTGGCATCTGCTGTGTTTTCTTCTGTGCACAGTGTGCATCTGTCTCTGTGGCCTTCAACTTCATCCTCGAGGTGAAGGCCAGGAGCTGTGACTGGGCATAGCCCGGCTCCTCTGCAGTGACGCTTGCACTGCCGCTTCCTTCCTCTTCAGAACCCAGCTTGGTCACCACATACTCAGCCCGGCTCGGGGAAGATGAGAGAGCTTGGGGACCACGGCTCCAGCTCCGAGCCTTGGACACACGCAGACTGTCGTGCTGCTCAGGCTCGGGGCTTGGGCTCGGGCTCGGGCCCTCAGTGGCTACACTCTGAT	72	82	95	105	10
2S43D:05056:08567	INITIAL_QUERY	TAGCCCTATCCATAAAACTAGGCCTCGCCCCCATTCCACTTCTGATTACCAGAAGTAACTCCAAGGGATCCCACTGCACAGTAGGACTTATTCTTCTTTACATGACAAAAAAATTGCTCCCCTACTCAATTTTAAATTCAAATTTACCCGCTACTCAACTCTACTATCATTTTAATACTAGCAATTACTTCTATTTTCATAGGGCATGAGGAGGACTTAACCAAAAAGGACACTGGATCTCCACCAGATAGATAGGCTCCATGAGCGGGGCTGTGCGGTCAGCACACTGGGCATACAGGCAGCGCGTGCTGTGGGCAAGAACCAAGAAAAGTTAATTAATAATCCACCAGTCCAGCCTAAACATTCCTACTTCCATACCTGTTTACATGGAATTATATCCAAGTAAACTAAGACAAGAAAACATAAAACAGAAAGTATAGGCTTGCCGCCGGTCGCAGACGATCGAGGGCCTCGAAGAGCAGGTGACCGAGATCCTGGGCGAGCGCGGACACCGCGAACTCCGACGACTGCTGTCGAACTGCTGGACGTTACGAATACTTAGCAGTCCGGCTTACAGCTAACATTACTGCAGGACACTTATTAATACACCTAATCGGAGGAGCTACTCTAGTATTAATAAATATTAGCCCACCAACAGCTACCAGAGAGCTCCCGAGTAGATGCCAAGATCCGCAGCGCCTCTTCTTTGAACCTTTTCCCAACCATTAACCCTTTGTCCGTATGCTGAAGCAACTTCTCTAAAAAAGTTTCCTCGAAATGAAAACTGGGTGCTTGGGAGGGATGGTTGGGTCCTAGGAAAAAAAAAAACTCAAGCCTCGACCGGATGGCCCCAATTAACGCCGGAAGGCCGTTCCCATTGGCAGGTGCATCTCTCCATTCTCGAAGAGAAAAAGATCCGGCTCCGGTTGCAGATGGAAGTGAACGACATAAAAGAAAGCTCTTCTAATTCAAATGATTAGCTTGATAATTGAGACATCACAATTTATTCATCCTGTGTCCAAAGACTCAGATATTCTGCCCATGA	183	193	585	595	10
2S43D:03232:11954	INITIAL_QUERY	AGCTGTTGGTGGGCTAATATTTATTAATACTAGAGTAGCTCCTCCGATTAGGTGTATTAATAAGTGTCCTGCAGTAATGTTAGCTGTAAGCCGGACTTGCTAATGTCATTGGTTGAATAAATTAGGCTAATTGTTTCAATAATAATAA	183	193	65	55	-10
2G5Z3:07093:14058	INITIAL_QUERY	GAGAGATAAGGTTTCCTCCAAGAACTCACTGGAGTCTATGCCTTCAACATGAAGCAACTGTGGAAGATGAGAACTTCAGGCAATCATATGGCTGCACATCAATCTCATTCCCAGCAAACAGGACCGAACCCTGACCATTGTGGATACCGGGATTGGAATGACCAAGGCCGACTTGATCAATAACCTTGGCACCATTGCCAAGTCGGGCACCAAAGCCTCATGGAGGCTTTGCAGGCTGGTGCAGATATCTCTATGTTGCCAGTTTGGTGTTGGTTTTTACTCTTGCCTATTTGGTTGCTGTAGAAAGTGACTGTCATCACGAAGCATAACGACGATGAGCAGTATGCAAAGATAGCCGGCTATGTCACGCATCTGATGAAGCGGATTCAGAGAGGGCCTGTGAGAGGCATCTCTATCAAGTTGCAGGAAGAAGAGAGAGAGAGGAGAGACTAACTACGTTCCTGAGGCTGGGAGGAGAGGCGATGTTTAAACTCTGCTCTGCTAGAGTAAGCCAGTTTGATAAATTCTTGCAAAGGAATTTCTGGAATTCTGTTCGCCAGGCTTGAGGGCCCTCTTCAACTTTGACTTCTTCTCTTCCACCTTACTCTGACCGCAATGCCACCTTCTGTTCCAAGAGCGCATACACCTCACCCCGGCCCGGACACGGACAGGATTGACAGATTGATAGCTCTTCTCGATTCCGTTGGGTGGTGGTGCATGGCCGTTCTTAGTTGAGAGTCTGTTCCCATGCAAACCAATGAGGGAGAAGTAGAGGAAGAAAGCAGCTCCCAGGTGGAACAGGAGGATTTTGTAATGGAAGGGCATGGCAAGACTCCACCTCCTGGAGAAGAAAGCAAACAAGAGAAACTCATTCTGGTCACTACAGAAGGAATCGCACTCCATAGGTACTGATTCATTATTATCTTCACTGAAATGTTTCTCACTCTGGTCAACCTCTTTGTGAGGTAACTCTGCATGGATGGGATGTTCAACCAGAGACTCTGTCGTTTCTTCTAGGAATTTATCTGATTGGGAGTTGTCAAGATTATGTTTTAAA	514	528	549	563	14
2S43D:02101:14274	INITIAL_QUERY	GTAGACCAGGCTGACCTCGAATTCAGAAATCTGCCTGCCTCTGCCTCCCAAGTGCTGGGATTAAAGGCGTGTACCACCACGCCCAGCTGATACTTCTCTTTACCATAGTAGAAAGACAGCCATCTTATTTATCTGAAAATTGTAGCACTCCCAGTTCATCAGGTTCATTGTGCCATCAGGGTTCTTTGTTGGGACAGCTACAAAGCCAAAAGGGTGGTCCTTCCTCCAGGCTTTCCTTTCCTGCGCAAGGCGGCTGAGGGCGATCCCCGACATATTCAAAGTCCCTGGGCGACCGCGGCCCGGACCGTCGGCGGCGGCAGAGGCGGCGGA	232	242	240	230	-10
2S43D:01932:02652	INITIAL_QUERY	AAGATAAATACACAATTTACACCAAGGAGAAGACTGTGTGTTTAATACTTGATAACATTGATTTTGATTAATAAGGAAATAATGTAGCTGGCGATGCCATGGGGCCCCAGAAGTGAGGAGTCCCAGTACTCAAGAACACCCAGGCTCAACCAGTTACCTCACACTTGACCTTCTCCTCAGACTACGTGGGCAGCCCTATCACCTGCACCTGCTTCAGCCGGGACGGGCAGCTGCACTCTGATATCCACTGGACTCTACTCTTGCGGCTTCTAGACTAAAGACAGGGGAAGCTGCTGGGCGAGTATGTTGGCCATAAGAACCAGAGTACAAGCTGGACATCTCAGGTAGTAGATTCCCTTGCTCCTGAATAACCTGAGGTGGAGGCTGCAAAACAGCTAATGGCAAAGTCTCAGGCTGACAGAGAGGCTGGACGTGAGCT	324	335	355	366	11
2G5Z3:07252:13808	INITIAL_QUERY	CTAAAGCTCCTGACCTCAGAGGGCCCCCTCTACCAAGCAGTGGCCAACTGCACCAGCTGCCGCCGTGACCTGACCAAGCCATTGCTCCAGCTTCAGGATCTAAGGAAGACGCAAGGGGTGGGGTTGGACTGATCCATCCAGCGTGGGGGCACTCTCTAGCCATTGAGGGTCCCAGGCGGTACCCCCCCTTTGTTTTCTTCTTATTGTCTTTTAAATTAATTATACTAGGAGCTAACAAGACTCATCAAGGTTAACAGCACTGGATGGCTCTTCTAGGATGACTGGGATTCAAGTTACTGGACAACCTCATGCCAGCCTACAACCACCTGGATTCCAAAAGACCATACTGACTCTATTTTGGTCAACCTCTCCCTGGTAGCCTCCTCAGCAGCCTCCACAAGGGCCCGGAGTTGTCCCAGCACTTCCTGCTTCTGGCCAGCAGGGACTTGAGGATTCGTTCAGCTGCCTCCTCCACCTGAGTCCCCACACTGGCTGCCTGCTCCCGTCATGACCCTATCAACTTCGATGGTAGTCGCCGTGCCATACCATGGCTG	105	115	57	67	10
2S43D:06834:07971	INITIAL_QUERY	GACAAGGTTCAGAAAGGTAAAATATAAAGGAAGCATTTTGAAAAAAAAAATAAGAAAGAAAAAGAAAAAGAAATGTATTTGAAGCTTCTGCAAGTCTGAGAAAAAAAAAACAAAAAAGAAAAACAAAAAAAAGGGGGGGGAAACAGGTCTGTGATGCCCTTAGATGTCCGGGGCTGCACGCGCCGCTACACTGACCTGGCTCAGCGTGTGCCTACTACGCCGCAGGCGCGGGTAACCCGCCCAGTAGAGGTCCAAAAGTGGCCGGCTGAAGATGAGGCTGTCCTTTCCTATCCAGAGCAGTGATGATGAGCAGGTAGACGGGTACCAGCCGGCGGGCTTCTGGATAGGGGTCCCTGTCAGGGGCGGTACGCTGCAAAGTCTCTGGCAGGGGCGTAGGGCTGGTAAGGCTTTCGAGTGAGCCCAGGCCTCCGGGGAGTCAACTTTTTTTCCAGGTTAACTTTGTCATCTCCAATACTCCTCAAGCAGTACATCACTCCTCTTGACAAGATGGGCAACAGTGTTAAGGGAATTCACTTTTGTCACGATCTTGTTTTCTCTGTGTAACTTCCATAACTATGATAATTTGAGACACTTTTGCAAAAAAAACTTGATCCTCGGAGAGAAAGGAGGTGGATCAAAGGCATTCCTTTGGAC	632	643	257	268	11
2S43D:00949:03037	INITIAL_QUERY	CTAGCCCATGACAGGAGCATCAGTAGACCTTAACAATTTTTCTCCCTTCATTTAGCTTGGAGTGTCATTCTATTTTAGGTGCAATTAATTTTATTACCACTATTATCAACATGAAACCCCA	310	320	7	-3	-10
2S43D:02066:10293	INITIAL_QUERY	CCATTATTTAAAATTATTAACCACTCATTCATTGACCTACCTGCCCATCCAACATTCATCATGATGAACTTTGGGTCCCTTCTAGGAGTCTGCCTAATAGTCCAAATCATTACAGGTCTTTTCTTAGA	392	404	36	48	12
2G5Z3:04429:07864	INITIAL_QUERY	TCTTGACAGTCGGAGGACACAAATACATGGATGATGATGGTTCACTTTCTCCTATTGAAGAGCCATTAACTGAAGATGAAGCAACAAATCCCTCAGGCTGAATGTGGATATCAAGTTGGTTGAGACAGTTGCTTCATAAATAGTTCAGAATTCTCAAGGAAGAGAAAGCTTGGAACAAGATGAAGATTAAGAAAGAATCTACATTTTCTAAAAAAAGCCAAAGAGTGCCACACCCTCCAGGATGTCTATAAAATTGGTAGGCATTGGCACTGTCCCTGTGGGCCGAAGTGGAGACTGGTTGGTTATTCAAGCCTAGGCTAATTGGTGGTTACCGATTCTTGCTTCTTAGACCCCTCTTGGTGCTTTTTGCTGTTTATTTCCATATTCGGGTTGGTATGAATGTGTTAAAGGGAAGGCCTCACTTTTCTATGTAGCCTTCTTTCTCTCCAGGTTTGCCTGTCTCCCTCTGCACAAGAGGGCAGAGGGCATGGCAGAGGGCTGCTGATTGAGCAGACCCCTCCTCCTCGCTTCTCTGGGGAAGATTGGTTTTGTACTGAGTCTGATGAATGGTTGGGGATGGTAACAGGCGGGGGTTTATGCCCACTGGGACTTGGTGAACTATGCCACTGGGATGGGAGATATTGTAAGA	13	23	172	182	10
2S43D:08886:13841	INITIAL_QUERY	GGCCTGGGAAGTTCTGGTTCTTTTTTCCTCCCATGTTGCCAATTCATGTTGTAGTTTTGGAGGGGTGGTGGAGAGCGCATGTCAATTATTCTGTGGGTTGGCGTAATTGCCCCGGCCTGTGGGGCGGGGACGGGGGCCCTG	141	151	15	25	10
2S43D:07983:11792	INITIAL_QUERY	CCCCCCCTTTTGCATTTTGTATTTTCTTTGATTGTTGTGCCGATGTTCTCTATGGAATCTTCTGCACCTGAGACTCTCTCTTTACATCTCTTGATTCCAGAACCTCCACTCTTTCGACCCCTTTGCTGATGCAAGTAAGGGTGATGACCTGCTTCCTGCTGGCACTGAGGATTATATCCATATAAGAATTCAACAGAGAAACGGCAGGAAGACCCTTACCACTGTCCAAGGGATCGCTGATGATTACGACA	355	365	124	134	10
2G5Z3:00943:09637	INITIAL_QUERY	CTTGTCACAGGCAAACACCTACACCAGTGATGAACTGAGCACAACAGAGAATGCCCTCTTCTGCCTCAAGTGACCCTTACCTGCTCGCACCACTGAATCCACACCCCCAGCATCTCTGAAAGAGGAAATGCTCTCAGAGACCACATATCATCAGTGTGTTATCCACTCGCTGCTGCCTCCTTACAGGAGCCCCACACCAGGCCATCTGCTTGAATGCTTCGGACACACTCCTCTAGTTTTGTCATGTCCGTCTCATCATCCAAGGCTTCACGTCTAGTAGGATGGAGACTTCGCAACAACTGCAGGCTCTAAGGAAGATTAAGAAGTGCACAATCCATGGAGAAATTGAATCTCGGTGCTGACTCAGACAGCTCGTCCCAAAAGAGCCCACCCCGGCCGCTCGGGACGTCGGGGTCCCGGGACCATCACGATTCACACATTCGCACCGTCAGTCGATCCTCCAGGAATGAATACAGATGGCTGTCACCCA	79	89	38	48	10
2S43D:07314:04666	INITIAL_QUERY	GTGCAGGATGCATTGCTGACAATCTTGAGTGAGTTGTCATATTTCTCGTGGTTCACACCCATCACAAACATGGGGGCATCGGCAGAAGGGGGCGGAGATGATGACCCCTTTTGGCTCCACCCTTCAAGTGGGCCCCGGCCTTCTCCATGGTGGTGAAGACACCAGTCCCTGAGGCGTCAGCTTGCGGCCCCCATCTTGGTCCTTTTCCACCATTTTCAGCCCCTCCAGGGCTTGGAGGACCCGGCGGGCCACACTCTTAGAGCCTCTGCTGAAATGGCTGGGTCTGACACCGAATGGAGAACACATGGGGGGATGGTCAGGGGGCTCAGCTGCATGCAGAGCCAAACAAGCTAAGCAGGAGTCCAAGGCCCAGTAGTGGGACTACTGGCACGAAGTCCGACCCCATTATCTTCATTATAGATGATGCAGGGCCCCTGCGCTGGATCCGCCGTCGGTTTCTCATTTTGCCCTTGCCAGCTCTCATTCTCTGAGAGGCATAGACCTTTTTGATGTCATTCCAAGCTTTGAGTTTCTTGAGCAGCTGAACAGCCTCCTTGGTCTCTTGTAACCTTCAACCA	125	135	432	422	-10
2G5Z3:09746:04536	INITIAL_QUERY	GGCTCTAAGGGCACAACATGGTGGATGACCTGATGGTCCCAGCCAACTGTGGTAAGAAGGGAGTGATTGAGTGGAGACCACGTAGCATCTCTCACAAAGTCTCTGTGGCTCGACTTCTAACACCTCAGAAAGGCTTGAATCCAGCACAGCAAGTGAACAGTCTTCACTGAGAGGCGTTTTTCTGGATATGGAGAAGAGGAATGTCTTAAATTTGGTCCACAATCTGCATCGTTAAGAAATTTATTTGTAAACCTT	77	87	8	18	10
2G5Z3:08541:01473	INITIAL_QUERY	CTGCAGTAAAGAAGGCAGGAAGACACTGCTAATATGTGTTCATTGCCCAAAATCACATTAGACCTTTAGGATGTTCGTTGCCTCAAATCAGCATTTCCACAAACACCAGGGTGACCGTAATGTCCTCATCTTCCAGTGCCTCATCAACCCAGCAGGTTCTGTCCCTCAGCACCTCAGCTCCTGGCTCAGGCTCTACTACTAACCTCTCCTGTCACCACCACGGTT	309	319	204	214	10
2S43D:07535:08077	INITIAL_QUERY	CCAGAGTGTAAGAAGCAAGAGAGCGCAAAGAAGCAAGAGAGAGAGAAAAACGAAAACCCCTTTCTATTTTAAAAGAGAAACCAACCATTTGCCTAGGGCGCATCACTCCCTTGATTGGACTTGCAGCCCATGGCCGAGCTGACGTTCACGGGAAAAACATTTAGTGAGGCCCTCGGATCGGCCCCGCCGGGGTCGGCCCACGGCCCTGGCGGAGCGCTGAGAAGACGGTCGAACTTGACTATCTAGAGGAAGTAAAAACTTCTCCCTGGTGGGCTTCACCCAGATGACTATCTGGGCCAAGGGCAAACACCGCAGCTACCTGAAGGAGTTCCGCGACTACCCGCCCCTGCGCATGCCCATTACTTCCCTTCCTGCTCTGAGCAGCTCCTCACGGCTCTGTCCAGTAATACTCTCACTGAGGGGGCCCGCGCCGAGGCCGCCCAGCCTCCCACCACCTCCACCAAGCCTTTAACGGCCAAGCCCACCTCCCTCGCCTGTGCTCTGGACTCTTCCAATGCCACTTTTCTGTTTATCCGAGATCATTCCACATTGTTCTTTCATCATTTCAGTTTCCTTGTAAAAGCTGTTCATGGCTTCCTGAGCTGAGAATTTTCTTCAAGGCATCTTTATTGCA	534	544	348	358	10
2S43D:07535:08077	INITIAL_QUERY	CCAGAGTGTAAGAAGCAAGAGAGCGCAAAGAAGCAAGAGAGAGAGAAAAACGAAAACCCCTTTCTATTTTAAAAGAGAAACCAACCATTTGCCTAGGGCGCATCACTCCCTTGATTGGACTTGCAGCCCATGGCCGAGCTGACGTTCACGGGAAAAACATTTAGTGAGGCCCTCGGATCGGCCCCGCCGGGGTCGGCCCACGGCCCTGGCGGAGCGCTGAGAAGACGGTCGAACTTGACTATCTAGAGGAAGTAAAAACTTCTCCCTGGTGGGCTTCACCCAGATGACTATCTGGGCCAAGGGCAAACACCGCAGCTACCTGAAGGAGTTCCGCGACTACCCGCCCCTGCGCATGCCCATTACTTCCCTTCCTGCTCTGAGCAGCTCCTCACGGCTCTGTCCAGTAATACTCTCACTGAGGGGGCCCGCGCCGAGGCCGCCCAGCCTCCCACCACCTCCACCAAGCCTTTAACGGCCAAGCCCACCTCCCTCGCCTGTGCTCTGGACTCTTCCAATGCCACTTTTCTGTTTATCCGAGATCATTCCACATTGTTCTTTCATCATTTCAGTTTCCTTGTAAAAGCTGTTCATGGCTTCCTGAGCTGAGAATTTTCTTCAAGGCATCTTTATTGCA	127	137	342	332	-10
2S43D:02996:00778	INITIAL_QUERY	AGAGTGACAAGTTCACACGGTTCTGCCAGTGGAAGAATGTTGAGCTCAACATCCACCTGACCATGAATGACTTCAGTGTGCATCGAATCATCGGGCGTGGGGGCTTCGGTGAGGTCTATAACTCACAAGATGATCCGTGAATTCCTGATAAGGAGACTTGGTGAAGACAGTCTCTTTCCAGAGGTCGGGAGTCAGGTAGCTGTAAGTCTTAGAGATGGCATCAAAGGTGGCCTTAGCAAAGTTGCCAGGGTGGCAGTGCAACTCCTTCTACGGGCTCAGCCTCAGCTCGGTCACGCTCCTCTGCATCCTGGAGGAGACTGGAAACCCCAAGAGTCTGACTGTATCCTGGTGGGAACAGCCATCCCATGTAACTTTGGTTTCAGTCCCCGGGTCTGTCCTTGGACAGCTCCCATCCGAGTCCCATCGGGAGGAGGGAGAGACAGGGAGGCCAGGTCCACGGCCACTTCGACCTCAGCCAAAAGCCCCCGAGTGGGGGTCCCATCCCGGCCAGGACAATGGGACTCCCGGCAGTGGCAGCGGGGCGGCCCGCGCGGGTGTTTATGTCGGGTCGCGGTGTCTCCCAGCAGCATGGCGGACTACCTGATCAGCGGCGGCACCGGCTACGTTCCCGA	442	452	409	399	-10
2S43D:05965:10798	INITIAL_QUERY	CTTGTCTGTTCATTGACCAAATGGTGTTCATAGAGGTTTCCACTAATAGGAATTCTCCCCACGTACATTCTTGTTAGTTCTATGAAGCTGATAATGAAGAGTTCACAAATCCCGTTTTTAAGATTTCTCTACAGTAGGTTCTTTCATGTCTGTAAGAGGATGTGATAACTCAAGACTATCCAAGACCGGCGTCTGTTTGAAGGCAATGCTCTCTGCGGGCGGCTTGTTCGCGATTGGGGTTGCTGGACGAGGGCAAGATGAAGCTGGATTCTCACTGGCCCCAGAGCCCAAGACCGCCAAGCTGGGTCCTCGGCGGGAGAGCAGCAGACCTGTGAAGCCTCCAAAGAAGGATGTACCGGACATAGAACTCCTGTAGCTGATAAAACACCATAGCAAAGTGGTTGGAAACATCAATCAAAAAGTAAAAATAAAAACAAAACCAAGCAGCCCTCCTATATACAATGACAATGGGGCAGAGAAAGAAAAGTTAGGGCGGCACATGTTCAGCCCGTATTTGCGGATCAGACCGTGGCGGTTGGAGCAGACGCGGCAAGAGCGGGAACCCTGGCCGAACTTCCGTGGGTGACTCCAGTAGAGCTGCTGGTGACCCATCTTGCCGAGTCAGGGTCTTCACGAAGATCTGCATGCCACCTCCTCAGGCGAAGGAGCCAGGGT	454	464	180	170	-10
2S43D:08181:03004	INITIAL_QUERY	CATGGGTGAGCCTGAGCTTGGATTTCACTGTGCCCAACCTGGGAGTGCTCCTGTGGCTGGCCCAGAAAATGCTAGATTTTCCTCCACTCGTCTGAACGGGGCTGGAGTCTAGGCTGAGGGTTTTCTCATTGACCCACCTGGAATCTGGTGAAGTATGA	210	220	52	62	10
2S43D:04429:13837	INITIAL_QUERY	ACTGCTCCTCTCGTACACTTTAAGCAAGAAGACTTGACTCGTCAATGATCTTCTCCGGCCCTCATGGGGATGAAAGAA	36	46	50	60	10
2S43D:05256:12658	INITIAL_QUERY	CTTGAGTCCAGGGCTTCAGGCATATAGGCAAGTACTCTTCCACTAGCTACACCCCTAGCCTTACATCATTTCTCCTTCTCCTAGCATCATCAATAGTAGAAGCAGGAGCAGGAACAGGATGAACAGTCTACCCACCTCTAGCCGGAAATCTAGCCCATGCAGGAGCATCAGTAGACCTAACAATTTTCACTCCAGCGCCTCTATAAGGACCACTTCCAGGGTCAGCTATGCTCCTTGGCTGAGCATCCCCATTGCGAACTTCCCTTTGCAGCGCTTGCTGGATGCAATCACTTCCCCTGAGTCTGTCTGGAGAGGGTCCTGGAGAATGACAGAAGGGTAGTCGTTCTCATACTTGAGGGACAGGAGTTCTTCCGAGCTGATAGGATGCAGCGTCTGATAGGACTCTGTGATGAAGCTGGGCTCTGAGAACTCTGAGGGAGGAACACACTGAGCATGCTCGATACCGTAGCTGATGAAGTAATCCGAGGTGTAACACAAGATCTGAAGGTCATCCGCAAGAACATCGTCAAGAAGTGCCTGGAGCTCTTCTCCGAGCTGGCTGAGGACAAGGAGAACTACAAGAAGTTCTATGAGCCTCTCCAAAATTAAAGCTGGAATTCATGAAGATTCCACTAACCGACGCCGCCTCTCTGAGCTCCTTCGTCTATCACACCTCTCAGTCTGGAGATGACATGACCTCCTTGTCGAGAGATATGTGTCTACGCATGAAGGAGACCCAGAGTCATCTACTATATCACTGGCCGCCGCGTCCTCCAAAGGCGCTTCTCCAGTCTCCTGAACTGTGGACCGCCGTGCCCCGCCGCGCCCACGTCGCGAGCAGGTCTTCATAGTCAGTATATTCGTAGCTTCAGTATCATTGGTGCCTATGGTTTTAACGGGTTAATAC	53	63	592	582	-10
2G5Z3:05984:08198	INITIAL_QUERY	GGGAGAGCTGGAGAGGTTTGGTTCCCAGGACTCATGTGGCAGCTCACAAGCTGCCTTTAACTCCCCGTAGGTCCAGTTCCAGGTGATCAAGACACCTCTGCCTCCTCAGGCAACACACACGGGCACACACACGGGCACACACACGGGCACACACACACACACGGGACTCTCACCAACACCAGCAAATACAGAGTAACCACCATGGGCTTGGCGACATTGTTGATTAGCTCCATGATCAGTACTGTCTTTCCAACGCCAGCACCCACCAAAGATTCCGATTTCCCACCCTTGGCGGTATGGGGCCAGCAGATATCTCCATGCGGAGCAGTGCTGACTGGCTGCAGGAGGATAGCTTCAGCTCAGCACATTCTGCTTGCTGAGTTCTTTGAAGTTCATAACCTACAAAGGGATCGCCTCCCCTTACGGCCGCCAGCACCACCGCTGAATCCTTTAGCTTTCACGTGTGAGTTGTA	274	284	332	342	10
2S43D:05441:12894	INITIAL_QUERY	CTCATCTTCTGGTTCGTTCTTCTTCTTTGAGCCTGTTGGCCTACCAGGACCCTTCTTTCCTGCTTCACTTTTGCCCTTGCACGGTATGCAGCAATATCCTTTTCATACTTCTCCTTTAGTTTAGCTGCTTTCTGCTCATATCGGTTTGTTTATCTTTGGCAGATTGCTCAGACCACATAGAGGAATCGTGCCCCAGACCCCATGAAGACCCCCGGAAGTAGCCTCAAGCCATTCAGGCCTACATCCATCGTTCCTAGGGACCCACCAGGCCAGCCAAGGACTCTGAGTGCAAAGCCAGTAAAACCCTGTCTCCAAATAATAATAATAATGATAAACTTGCTACAAATTATCAACTACGCAGATAATATTGCCACATCTAAAAGAACTCACAAAATATTGTTTGGTTTTTAACAAAAATGGCTTTTTAAAAAATAAAATTTTTGATTTAAAAAATGCATAAAGATAATGGGAAAGAAGTAGATAAAAAGCCACTTTCTTTGAAACCACTCATTCATTGACCTACCTGCCCATCCAACATTCATCATGATGAAACTTTGGGTCCCTTCTAGGAGTCTGCCTAATAGTCCAAATCATTACAGGTCTTTTCTTAGCCATACACTACACATCAGATACAGGACCAAGAAGCGAGTACTTACTCTTCGTAAGTCCTTGCTAGGTTCGAGACCAAACGGCGGGCCTGGAGAAGATTACCAGGAATTCATTACACCACCTCCAAATTTGGCCATTGGTCGCTTCCAGACCATGGAGGAGAAGAAAGCACTTT	392	404	519	531	12
2S43D:00273:09462	INITIAL_QUERY	GCTCGGAAGTATTTTTCTTTGCAGGATTCTTCTGAGCTGTTCTATCCTATTCTAGCCTCGTACCAACACTATGATCCCGGGTTCCTGACCCCACCTCCCCCAGTTCGCCCTCAGTCGAAGCACTCGTGCCATGTCCTGCTGGGAATTTTCTGCCCATGGCAGGCAAGACCATCAGCACCGAGAACCCTGACAGACAACTACATACCAGCTAATCCTAACTCATGGCCATGCACTCAAGGCCGTCGCCCTGGTGCAGGGGTTCGCAGGGCTGCATCCGGGTTCTGGTCGTGGAAGTAGATGGGAGGCAGCCATGAGCAGGAAAGTGGTATTGGTCACATCCACACTCCTGCTCATCTCCCGATCCACTCCAGCACGATGCTGTCCCTCTGGTTCTCACTGGCAAGGTACTCAGCAAACATGCGCGACACCTGGATTCTGGGGCCGAGGAGGGTTGAGCTAGGCATACTTAAGTCTGTTCCTTAGGAAAATGATGAGAGGCAGGCATTCCCTCAGCTTGTGAGGACCAGTGGATGGACGAGGAGCAAACACGCCAGTCAACTTATCCAGCATCCAATGTTTTGGAGCAGCTACACGCTTCAGGTGTTTCTTGGGACCACGAGCCATGGCTGCGCAACAGCTTCCACATTCCTAAGAAAGGCCCAAGCCGCCAAGAAGCCAGGGAAGCACAGTACAAACCTCTGAAAGGCCAAGGGCAAGCAAGGCAAAGGCAGTACCGTCCGCCCCCGGATCTCTGCTGTTCTGGCATCAGCACCGCCGGCCCTGGGCAACGATGTACAGCGAGGACCTTAGCTCGGGCGAGGGAGGCCTCCCGGAAAGTGTTCTTTTTGGA	142	152	838	848	10
2G5Z3:02372:10942	INITIAL_QUERY	GAGACTCCTCCAGAAGCTCCCCTTCAGCCCAGGTCACTCATCCGAGAATGCACGAGGTGATCTGAAGATGTGCCCAGTGAGTGCGGCCATGCCTCCCTGTGTCCCTGTGAAGGTTGCTGA	74	84	68	58	-10
2G5Z3:07734:08338	INITIAL_QUERY	CTCAACCAGATCTTCTGCATAATAATGAGGGAAACCCCACGAGCAGATCCTGAAAGCCAAGTTAGAAGTTAGAAAGAGCAAGCAGCTGGAGCAAGGGCCCATGATAGAACAACTGAGCAAGGTGTTCTACACCACGAAGCATCGCTGGTACCCGCACGGACAGTATCACAATCGTCGTAAGAAACTGAATCCTCCATCTTCGTTTTCATTCACATCTTCCTTTCATACTTCTCGCTAGCTGACTTTCAATAGATCGCAGCGAGGGGAGCTGCTCTGCACGTACCGA	322	332	114	104	-10
2G5Z3:09933:12740	INITIAL_QUERY	GCCTTGACTGTGCCGTTGAATTTGCCGTGAGTGGAGTCATACTGGAACATGTAGACCATGTAGTTGAGGTCAATGAAGGGGTCGTTGATGGCAACAATCTCCACTTTGCCACTGCAAATGGCAGCCCTGGTGACCAGGCGCCCAATACGGAGGGACAGCGGGCCGGCCAGGAGCGGGTTTCGAACAATTCACGACAGCCTAACTAACAGGGGTGCCATGGGTATCATGCTGTCTACGACATTACCAATGAGAAGTCCTTTGACAACATCCGGATTGGATTCGGAGGCGGGCAAAGCCAGGTGCTCTGATGAGCTCGTACACTGAAGGCCCTGTCAGGACCTGTAGCCCTGGAACACCCAGGACCGCTATACTTCACATTGGTAGCCTCGATGGACATGTTCCACACACGCTTCAAGCAAGAGGGTGTGCTTAGCCCCAAGGTTGGCATGGACTACAGGACCAGGCATCCTGAGGCCAGGGGGCATCTCGAGGACGCCAGCCGCCATGCTGAAGCAGTC	97	107	300	310	10
2G5Z3:10219:11430	INITIAL_QUERY	GGAGCCCAGGGATAAAGGTGACCTGGAAACAAGGGACCAGGAAACCGTTGGAGTATGTGGTGGACTGGGCTCAAGATGGTGACAGCCTGGACAAGCTCAACTGGACCCGTCTCCCCCCTGGAAACCTCAGCACTCCAGTACTTTCAAACAGGCCCTGGCCACCCTTTGCTCTGCCCGGGCATAGACTGCACTCCCAATGCACGAGGAGGCCAGGGCTGGGGCTGCATTGTCCTGATCGTGTACTGGGCAGGATCGCTGTGTCCCACTCCCTCTGCTCTTTGCCACAGAGACA	301	311	244	254	10
2S43D:08155:01482	INITIAL_QUERY	CACCATCTCTGTGCCTGGTACCTGGGGCTCGATGTTCCGGACCCGGAAGGAGGATGGTGTGCTGATGGAAGCCACAGCTGGCACGTCTTCCAGGCTCCATTCTCCAGGCTTTTCCAAAGATTGTATATATTCTCAACAGCTACTCCGCTTTC	447	457	63	73	10
2S43D:03426:12114	INITIAL_QUERY	CGTCAGTACCTGCTCAGTGGTCAGCACTATGACTTCCCGAGTTACCGGAGTGCGTGCACGAGGTGACCCAGGCCTTCGCCGCTGCCTCGCGGGATGGTATTGGCAGTGGAAGCAGAGTTGGCAGGGCC	192	202	79	69	-10
2G5Z3:04249:11791	INITIAL_QUERY	GGCTCATCACAGTTTGGATGCGAGCACACACAGATGGGGCTTGGCGCTTGTCTAAGGCTTTGGCAGCTTCGCGTATGCCACGTGCTAGGCCATCGTGGATGAGGGCGGTCTTCAGCACCTCTTGTAGAGCAGTGTTGACCGTCCATTACATCCTCCAGCAGCTATGCCTCCTCGGCCATGGCGGTGAACTCACGGTGACGCCGAATCTTGAACGCACCCGAGCTTCCGCCTCCGCGCAGTCGGCAGCCCTGGAAGGCCAACACCAGGGATATGGACCAGCTTGAGTGACAGTGTTTTCTGCAGCAACATCGAAGAGGAACTGAAGCTGGAGGATGACGGGTGAGTCTGCAGGGGTGGGAGGGAAGGAGCCACAAAGCCTGTCTGGCCTGGGCCCCCATGGCCCCAGGTACAGTTCAAACACTCTGTTCAGCTGCTGCAGTGTGGCTGTCAGCAGGCTCAGTGAGGGGAACTCATAGACTTAATGCTAGTGTGAGTGATAGGGTAGGTGCAATAATAAATAAGGATATAGAGGTTGTTAAAGGGCGTATTGGTTCTTTATAAATAATTTTATGGCGTCTGCAAATGTTGTAAAATGCCGTATGGACCAACAATGTTAGGGCCTTTTCGTAGGTTGTATGGCTCTCTTCAGGCAAGTGGTGGTGCTGTCTCGTTAAACTCTTTGAACCTGACTTGGAAAGCAAATCAAAATGGGAATTATCCTTAGAAACTGTGCCTACAATGGATGGACTGGAGGGTATCATACTGAGTCGAAGTAACCAATACC	119	129	442	452	10
2G5Z3:01751:03209	INITIAL_QUERY	GGAGTGGCCATCCCATCTCCTGCGGTCTGCCGCGAGCTGCCTGGAAGCAGGCTGGCATTGGCCTAACAATGGCAGGAAGTCCCGCCCCTCGCCGGCTGAGGGGAGACCTAGCGTCGGCCTCTGAGGCCGCTGCTGCATATTTTGCACAATCTGGGGTGGGAGGGAATCCCTACTTTCAAATCCCACGTCCCAGTGAAAGCACAAAGACTCTTTTTCTCTTCAATTCTCCTTTTCTGTGAATGGCACTCATCTGCCACACAGGAAGGATCTATTTGCACCAATGTGGCACACACCCAGCCAGCTTTCAAGAACTGGAAAGAT	638	648	289	279	-10
2G5Z3:02341:12115	INITIAL_QUERY	GTCGGGAGAACTCTTCTGGTGGGTGAGGAAGGTGACAGGAGGGACGGACAGACGCACTCATTCTGTCCAATCCTTCTTAATGGCCAGGTTCCATTCCCAGGTGAGGTGGATCCTTCGGTTCCAAGCGGGGTAAAGTCCTGGGCACAAGCCAGTGTCACCCATGGAGCCCATGGAGATGGTGGAAGGGCATCAAACCTACTGTCGCGATTCTCTCGAGAGGAATTTCCGACCCTGCAGGCGGCTGGAGACCAGGACAAGGCTGCCAAGGAAAGGGAGTCTGCCGAACAGTCGTCTGGGCCCGGATGTCCAGACACCTCACCAGGCAGCTGCCAAGAGCCAGGCCTCTGTTTTAGCACACTCCTCAGGGAACCCCAGGAGGTACCTGCTGTTGGCTCCGGTTCTTAGGCAGCAAAGGCAGGGATCCACCCCTGCCCCGGGCTCTCCTTGGGACCCTACACAAGAGGCTAGGGACCCTTGCAATACCTCGAACACAGGCAGGCTGTGCCTTCTGCCGTGGCAAGCGCACCTACGGGCTGACTCCTCACTACATCTACCCACCCAGCTTGTGCCAGCCCAGCCCCTGGTACACGCACTGTCAGTCAATACTCCGGTGTGAACACAGGTTCCTCGAAGTAAATCACATTCTGATGAGGGATATGCAGACACGTCTGGCAGAGTGGGTATCTCACTTGGTAGGAACCTCGTACTTGAAGATGACAGGCAAGCCCGGCCGTCCTGGTGAGCGTGGACCTCCTGGCCACTGGCTGGTGGCTCTGCCGGA	75	85	137	147	10
2G5Z3:02341:12115	INITIAL_QUERY	GTCGGGAGAACTCTTCTGGTGGGTGAGGAAGGTGACAGGAGGGACGGACAGACGCACTCATTCTGTCCAATCCTTCTTAATGGCCAGGTTCCATTCCCAGGTGAGGTGGATCCTTCGGTTCCAAGCGGGGTAAAGTCCTGGGCACAAGCCAGTGTCACCCATGGAGCCCATGGAGATGGTGGAAGGGCATCAAACCTACTGTCGCGATTCTCTCGAGAGGAATTTCCGACCCTGCAGGCGGCTGGAGACCAGGACAAGGCTGCCAAGGAAAGGGAGTCTGCCGAACAGTCGTCTGGGCCCGGATGTCCAGACACCTCACCAGGCAGCTGCCAAGAGCCAGGCCTCTGTTTTAGCACACTCCTCAGGGAACCCCAGGAGGTACCTGCTGTTGGCTCCGGTTCTTAGGCAGCAAAGGCAGGGATCCACCCCTGCCCCGGGCTCTCCTTGGGACCCTACACAAGAGGCTAGGGACCCTTGCAATACCTCGAACACAGGCAGGCTGTGCCTTCTGCCGTGGCAAGCGCACCTACGGGCTGACTCCTCACTACATCTACCCACCCAGCTTGTGCCAGCCCAGCCCCTGGTACACGCACTGTCAGTCAATACTCCGGTGTGAACACAGGTTCCTCGAAGTAAATCACATTCTGATGAGGGATATGCAGACACGTCTGGCAGAGTGGGTATCTCACTTGGTAGGAACCTCGTACTTGAAGATGACAGGCAAGCCCGGCCGTCCTGGTGAGCGTGGACCTCCTGGCCACTGGCTGGTGGCTCTGCCGGA	298	308	427	417	-10
2S43D:09871:09006	INITIAL_QUERY	CCACCACATACTCCAACGGTTTCCTGGTCCCTTGTTTCCAGGTCACCTTTATCCCTGGGCTCCCATCAGCACTGCTCACTCCCACGTCACAGGGGGCAGATTCTGGAGCCAAGCACACACTGGGCCCAGTGGCCCCCTGCCCCCAGCCACTCCATGGCCCCTGTCATCTTTTGTCCCTTCTCAAAAAACTTACCAGGGCAACTTATGGACTTCCACCTGGGCTTCCTGCAGCTCCTGGGGACGTGTGCTCCGGGCTCGGAACACACATTTATTATTAAAAAATCCAAAAAAATCTAAAAAATCCATCCTCAGGTTCAAGCAAGTCAGCCCAGTGAGTGAATGTGTACTACCAGAACACCTACCGAGTACAATGGCCATTCGGTGCATCCTATGGGCATACCGTATAGTTACAA	312	322	159	169	10
2S43D:02502:03630	INITIAL_QUERY	GGCAATAGGACTTAGGAATTGGCATTGGGGCCCTTCTTCTTCCCAAAGGTGGGCACAACATTGACAAAGCGCCGGTTGTACTGCATTCGCCTCTTGGCCCGGCCTGTCTTCTTCTTCTTCTTTTCCTGTTTGGCCACCTTGGGAGTCTGACA	76	87	49	60	11
2G5Z3:06933:01495	INITIAL_QUERY	CCAAGTTCTGTCCAGAAGCAAAGAGGACCCCTTTCTCCCAGGCCTCGAGATCACCGCTTCCGTGGAGCTTCGCCGACACAGCCACCTCTTCTTCTGCTTCAGGTCATCGTACTCATAGAGACCAAGCACAGCTCCTCTGCAGCAGCTGGTACCCTACCCTCGCATCCACTTCCCTCTGGCCACTTATGCCCCTGTCATCTCTGCTGAGAAGCCTACCATGACGCAGCTTTCTGTAGCAGAGATCACCCTACACCAAAGAGTGAGCACAAAGCTGTTTTGAAAAGACTCAAGGAGGAACAGACTCGAAAGTTAGCCATCTTGGCTGAGCAGTATGATCATAGCATTAATGAAATGCTCGTCCACACAACGCTCTGCA	312	323	190	201	11
2S43D:00940:03977	INITIAL_QUERY	ATTTGCAGACGCCATAAAATTATTTATAAAAAGAACCAAATACGCCCTTTAACAACCTCTATATCCTTATTTAATTATTGAAACACCTACCTTATCTACTCACACTAGCTATTAAAGTCTAGCCACACACAGAGAGAAAGGGCACAGAAGAACCTTGAAAGGAAATGAACATGTGGACTATTGAAGAAGGCTTGTCTTATTATAACAGAATGAAGTAC	141	151	27	17	-10
2S43D:01824:02348	INITIAL_QUERY	GGTGGTGCGGAGCGTGTCGGCTTCGAGCTCCTCGCAAAAGTGTGGCGTCGCGCTACGGCTGGCGGCGGAGCCTACAGAGGAGAGCGTGGTGTTGGTGCATGTGTTTCGGACTCGGGCCTCATGCTTGCTGGCGTCATCCTCGGAGGGGCGTACCGTGTACAAGTATTTTGCCTCTTCAGCCAGATGATGTGTACGTACTGTGGACGGCAATCATGTCTCGAATTTTTCTGTAGGCATTCTGCCAGATTGCGGAACTGTATACCGGCTGCTCTCAGAGGTAAGTACCAGTCTCCTGCCTTGTTGATCTTTATTTTTATGCGTGATGGGCATCTTCTGGACGCACGGGCTCCTCAATCCAGTCTGCACTGGCCAAGTCGAAACCTTAAGTTATCTCCTCTGATGGTCAGTTTGCCCTCTCGGGCTCCTGGACGGA	93	103	262	272	10
2G5Z3:04758:14393	INITIAL_QUERY	TTCTAGCTTCCTTCTTAACCTGTGTTCCTCCAGGGCTCTGCAGATATTGATATTTGAGATGACATCTCCATATATCAAGAGAAAGTCAGAGCGCACCAAGCCTTGGCATCGACTCACGGAGGACGTCGTCCTGAAGATCCTCTGTTGCCTGTTCCTGGGCCAGAGTCCACCTAGCTGAGGAAAGGTGAGATTGCGGCACATCCTTCCTCTAGCAGTCTTGGAGCTGGGACAGACAGTGCCTCTGCTCTTCAATCAGTGAGCCCACAGCTTGATGGAGGCGTCACAGGCACCTGACACAAAGGTGCGCGGGGCCAGTCGGCACAGGGACATCGACCATGCCCACGGGCAACCAAGGAAGCATAAGAGAAAAAGTGGGCAGAGGGGATAGCAGTAGCATATGGACTCAGGCAGTTCAGTGTCTCAGCCAAGTCACTCAGTTCACGAGTTGGTGGACC	314	324	54	44	-10
2G5Z3:09620:06691	INITIAL_QUERY	AGAACTTACAGCTAACATAGTGAAATTGGAAAGATACAAAACACTTACAAAGCTGCTTGAGAATGGTGATGAGTGACAGCTGCTGGACCAACATAAATACCTCACGTTCTCCCTTGAAGACGGTGCTTCTTGAGAGTCTGTTGTGCGCCCCCTGCTGCCAGAGGCGCGAGACGCGTGAGAATCCAGATGTGTTTGCCCTTTGGACGGTCTAGCCAGCATTAGGAAGGGGGTAGGGGGCGAAAAG	79	89	136	126	-10
2G5Z3:02507:01342	INITIAL_QUERY	GCTGTGCTCGACGTTGTCACTGAAGCGGGAAGGGACTGGCTGCTATTGGGCGAAGTGCCGGGGCAGGATCTCCTGTCATCTCACCTTGCTCCTGCCGACTTTTGGCTGTCAGTTGTACATATCTAACAATTTCTAGTCTCTTTATTTAAGACCAATGTAGCTCTTCCTCCACTCATGCATCATTGTTTTGTTTTCAAGCAAG	241	339	0	98	98
2G5Z3:04456:12000	INITIAL_QUERY	CTAACCTCATAATTTTATCATTCACAACACACACCTTAGAGCTTCATGATCTAACAACTTACTATGGTTGGCATGCATAATAGCATTTCTTATTAAAAATACCATTATATGGAGTTCACCTAATGACTACCAAAAAGCCCATATTGAAGCTTCCAATTGCTGGGTCAATATTCTAGCAGCTATTCTTCTAAAATTAGGTATTACGGATAATTCGCCCGTGACGCACCACGCCGTGACTCTCCCAGGGAAGCAGGGCGAACCTGGAAAGTCCTTGTTTTGCGAGTACAACACTCAGAGCCCCAGGAAAAGTTCCCCACATCCAATCTCAGGGCACGGTACTTCTTATTGCCTCCTCGAACTCGGACTGTGTGTATGCGGCGAGGGCCAATCTCGTGTTGGCAGCGGGCCGTCCCAGCTCATACTTTCGCTTCTGTCAAGTAAAGAATATGTAGGAGAGGTGTTATTTCAACAAACAAGTAAAATGGACAAAATGGACAGTTTGCAGACATAAATGTTAAATTTATGTATCTTGATATACTTAAATCATGTATGAACTAATAGTGCTATGTACATTTCCATCGTTTTACTTGGGGCTTATACGTAGTTTAAAAAAGTCGATCAGATACCTGTGAGTTCCTGTTACTAAACCGGTGGACGGGCAAGTTAGTTCCTTTTGATTTATAAGCTCCAGCACACTGGGGGCGCCGTCAGGTCGCAACCCAGTCCATCTTGTGTACCCTTGGCTTCAGTACTCGGACACTTTTTTTTTCTCTGTCGCAACCAGTCAAGTTCTCAAGTTTGTCTCTGTTTATTTTTTTTTCTTTCCATTGCCCCTCAGCCCTGCAGTCTGTTCTCAAACGTTTGCAACTGCTGCGTTAGCATGAGTTGGCACCACTGTTAACGTGGTTCA	15	25	723	713	-10
2G5Z3:00054:06714	INITIAL_QUERY	GTCAGGGCTGGAAGCGTGGCGAGCTGATGTGAGGCTGGTGGAAGGCATGGGCACTGTATACCACCTCGGGGGGCGAGGGGGTGCCACTGGCCAGCACGGAGCACAGGGGCTCGTGGCTGCTCAGCACTGATGTGAAGTACTTGAGCA	493	503	103	113	10
2S43D:06686:00522	INITIAL_QUERY	CTCTACCCTGTGCTAAGGTGTATGAGTTTCGACCCCAGAGCTCTGTGTGCTTCCATGTTGTCTGCTCTCATACAATAAAGCCTAGAAAGCCAATAGACATTATTGCTCATACTATTCCTATATAGCCGAAAAGGTTCTTTTTTTTCCGGAGTAGTAAAGTAAACTACATGTGAAAATAATTCCAAATCCTGGGAGGATAAGAATATAAACTTCTGGGGTGCCCAAAGAATCAGAACAGATGTCTGGTAGAGAAATTGGGGTCCCCCTCCTCCAGCGAGTTGATAGATGGATAAATATTTACAATTTCCTGTAACAGTGCTGCAATAGTACCAAATGAATGCCATAGCATGGGTGCAAGGTCAGGGACAGACTCTCTCTTCTTGCTCAGCTACCAACAAAGTCATTTTCCCTTGTCTCAGGACTGGACAGTTTCATTATCCACTGATTAGATCTCTCTCTGCCACTTGGGCTAGCCGATGTCCACTTCAAGCCACTTCTTCATCACGTTGTACTTCTTGAAGAAGCAGGTCACAGTCTGCCCAGCCTGGTACTGCCTGATCTTCTA	141	151	132	142	10
2S43D:08076:07199	INITIAL_QUERY	TTCCTGAAGGTGCAACCCAAGAGCCTACGCGGCTGGCCCAAAAGCAGTGGCTTCAGGCTGCTGGCTTTCAGTGGATGACAATGGTCCTCTGCATCTTCATCTTCGTCACGACACCAGACAGGATCCGACCTCGGATGGAGACGTTACCAA	443	453	129	139	10
2G5Z3:01493:09945	INITIAL_QUERY	GAGCAGGCAGAGCAGGAAGTCCATGATTTGAAGGGACAGGAAGGGTATCAGGTACTTCTCCCGGTTCTTGACCACGCCGAACAGCAGGCTGATGCTGATGATGAAGAGCACGCCAATGAGCAGGAGCTGGAGAGCATGGCAGCCATCCTGAGGATACGGCATCTTGAAAGAACCTACAGGACACTTACCGCGGGACCACCTCCACCTACCATGAGCCACTAAGTAATGTCCCAAATTTTCCAGAAGAAAGACTACAAACAGTATCTTTGTGACCCTTTAAAATATAAAGTGGCATTGGACTGTCCAGCGAGAAAATGCAAATATTGTGGTCATTTCCTCCAGTGGCAA	138	148	59	69	10
2G5Z3:06364:07259	INITIAL_QUERY	CTCCTATAAATAATCTAGCATCGACATTTGGGTATTTTCCAAGCAATTTCTTACATACATCAATGGCTGGATCATCATGATCTTGTACACAAAGGAGTACTTCATATTTGGACTTTGTAGACCAGGCCTGCCTCTGCCCTACCCAGTGCTAGGGATTAAAGGCGTGCGCCACCTACTGCAGTGCTGGAGATTCAGGGCAATGGCGAGTCCTCATATGTGCCACAGGAAGCCATCAGCAGTGCCATCCAGCTACTAGAAGACTCATTACAGAGGGAGTTTATTCAAAAGTGCCTGCAGTCTGAGCCTGCTCGGAGACCAACAGCCAGAGAACTTCGTCCACAATCGACTGTGGCCGGCTGGGTGTGGCGGACCGCTAATCAGGCACATAGCGTTGGCTACCCCGTGATATTGACTGAAAGAGGCTTGGCGGCGAATGGGCTGACCGCTTCCTCGTGCTTTACGGTATCGCCGCTCCCGATTCCGAGCAGCGCGAGCTGGCAGAAGTAATCATATGTGTTCTTGGGTTGTAATAAGGTGTTTGATAGAGTAGTAGGATCCATTGACGCAGATAATGTTGAAACCTCAATACCCCAGCCATGACGTGCCATTCAGGCGGTGCTGTCCTTGTATGCATCTGGCGCACCACTGGCATTGTCATGGACTCTGGTGACGGGGTCACACACACATGCCACTATGAGTACGTTCTGGTTACTTACATTCTGTTTCTTGCTTTAAAAGAAGGACAAGACTGTTGGACCAGTATTGCAATTCTGTAGAGTCTTTCTTATTAAAAACAATAATGTGATTACCAAAATTGGCATATTTAAGGCCTAATGCCATTCTAATAAAGACCTGAGACTGTCCAAGCACACGAGGGGATAAGGGGATGTTAAAAGGGACATAAGCTTGTTTTTCTTGATGAATGGCAGAGCTTGCCTCTGGACTTGCCGCCAAATCTGAGCTCAGGCTTGCCTTCAATGGTCTCATGTGGCTTTGGCTGGCCCTCAAAGTTGCTAAGGATAACCTTACATTTTTGATTCTCTGGCCTCTACCTTGTGAGTATCATGATGTATTGCAAGCATGAGTCACCAGACCTAGTTTTCATGATAATACGTTGCTTCCTCAGACACAGGTTTAGTGTCCATCCTTATTTCAGTTCTTCTGTGCACATACATGGCCAAAACAAAACAAAACAAAAACAAAAACAAAACAAAACAAAGACAAGACAAAAACAAACAAAACCTTTACCTTGTGTTTTCTTTAAAGAGAACACCCAATGCAAGGGATAGCGTGCCATGAAGTAACCTGAAGGAG	625	648	341	364	23
2G5Z3:06364:07259	INITIAL_QUERY	CTCCTATAAATAATCTAGCATCGACATTTGGGTATTTTCCAAGCAATTTCTTACATACATCAATGGCTGGATCATCATGATCTTGTACACAAAGGAGTACTTCATATTTGGACTTTGTAGACCAGGCCTGCCTCTGCCCTACCCAGTGCTAGGGATTAAAGGCGTGCGCCACCTACTGCAGTGCTGGAGATTCAGGGCAATGGCGAGTCCTCATATGTGCCACAGGAAGCCATCAGCAGTGCCATCCAGCTACTAGAAGACTCATTACAGAGGGAGTTTATTCAAAAGTGCCTGCAGTCTGAGCCTGCTCGGAGACCAACAGCCAGAGAACTTCGTCCACAATCGACTGTGGCCGGCTGGGTGTGGCGGACCGCTAATCAGGCACATAGCGTTGGCTACCCCGTGATATTGACTGAAAGAGGCTTGGCGGCGAATGGGCTGACCGCTTCCTCGTGCTTTACGGTATCGCCGCTCCCGATTCCGAGCAGCGCGAGCTGGCAGAAGTAATCATATGTGTTCTTGGGTTGTAATAAGGTGTTTGATAGAGTAGTAGGATCCATTGACGCAGATAATGTTGAAACCTCAATACCCCAGCCATGACGTGCCATTCAGGCGGTGCTGTCCTTGTATGCATCTGGCGCACCACTGGCATTGTCATGGACTCTGGTGACGGGGTCACACACACATGCCACTATGAGTACGTTCTGGTTACTTACATTCTGTTTCTTGCTTTAAAAGAAGGACAAGACTGTTGGACCAGTATTGCAATTCTGTAGAGTCTTTCTTATTAAAAACAATAATGTGATTACCAAAATTGGCATATTTAAGGCCTAATGCCATTCTAATAAAGACCTGAGACTGTCCAAGCACACGAGGGGATAAGGGGATGTTAAAAGGGACATAAGCTTGTTTTTCTTGATGAATGGCAGAGCTTGCCTCTGGACTTGCCGCCAAATCTGAGCTCAGGCTTGCCTTCAATGGTCTCATGTGGCTTTGGCTGGCCCTCAAAGTTGCTAAGGATAACCTTACATTTTTGATTCTCTGGCCTCTACCTTGTGAGTATCATGATGTATTGCAAGCATGAGTCACCAGACCTAGTTTTCATGATAATACGTTGCTTCCTCAGACACAGGTTTAGTGTCCATCCTTATTTCAGTTCTTCTGTGCACATACATGGCCAAAACAAAACAAAACAAAAACAAAAACAAAACAAAACAAAGACAAGACAAAAACAAACAAAACCTTTACCTTGTGTTTTCTTTAAAGAGAACACCCAATGCAAGGGATAGCGTGCCATGAAGTAACCTGAAGGAG	171	181	189	179	-10
2G5Z3:08818:12305	INITIAL_QUERY	TCTTGTTCCATCAATAGGCGAATCTCATAAGCATCACGGCTCAGATTCATGATGAGGGAAAACAGATAGTATCTGAATGAACGCTGTGCCCACTTTTCCA	175	185	72	82	10
2G5Z3:03542:06719	INITIAL_QUERY	AAACAACCACACCTAGCATTCCTACACATCTGTACCCACGCATTCTTCAAGCTATACTCTTTATATGCTCTGGCTCAATCATTCATAGCCTGGCCAGACGAACAAGACATCCGAAAAATAAGGAAACATCAACAAAAATCATAACCATTCACATCATCATGCTGGGTAAATGGAGAACTCCAGCTTGGACTTCTTTCCGTAATCCACAGAGCAGCCGCTCCAGTCAGCAGGGAGGTGAAGCCAGTAGCCAGTCCCCC	93	103	207	197	-10
2S43D:00740:13395	INITIAL_QUERY	GAGCATAGTAGTCAGTTTTACCCCTCCTCGCCGCCTGAAATCTCACCCCCCTTTCTTTCTTTCTTTCTTTCTTTCTTTTTTTGAGACAGGGTTCTCTGTGTAGCCCTGGCTGTCCTGGAACTCACTCTGTAGACCAGCTGGCTTCTAACTCAGAAATCCTGCCTGCCTCTGCCCTCCCAAGTGCTGGGATTAAAGGCATGTGCCACCGTGGGCTAATATTTATTAATACTAGAGTAGCTCCTCCGATTAGGTGTATTAATAAGTGTCCTGCAGTAATGTTAGCTGTAAGCCGGACTGCTAAATGTCCATTGGTTGAATAAAATAAGGACTTAATTTGTTTCAATAATAATAA	183	193	264	254	-10
2G5Z3:02215:03443	INITIAL_QUERY	CCCGTCACCAAGCTGGGCCGTCTGGTTAAGGACATGAAGATCAAGTCCTGGAGGAGATCTACCTGTTCTCCCTGCCCATTAAGGAGTCTGAGATCATTGATTTCTTCCTGGGTGCGTCCCTAAAGGATGAGGTTCTGAAATCATGCCAGTGCAGAAGCAGACTCGGGCTGGCCGAGCCGGGACCAGGTTCAAGGCTT	395	405	70	80	10
2S43D:06066:10538	INITIAL_QUERY	GCCCGTCCTTGGCTCGGAGCTCGCGGACTCGCGGACAAGCGTCCTCAGCGCGAAGAGGCCGGACTCGGAGTCCTCGCCTTGAGCCTTGCATCTGAGAAGTTCCAGGTACTTTGTACAACTGCATCCCAGA	523	533	76	66	-10
2S43D:07386:09171	INITIAL_QUERY	CTTGCCTTGTATCAAATCTTTATTATCTTCCGTCATATGAGGACAGAGACCAAAAATGCTATCCATTGGAAATAAATTTTCTTTGATTCTTTGTCCACTTGGTCATTTTTCTTTTTCAGTACTAATGCCACAGTTTTGTCTCAAATACGCCTGCAGAGTTAAGCATGCCAGTATGGCCGAGCCCAAGACCGTCTACTGGGATCGAGACATGTGATCAAGCATCATGATGCTCTGAAGATTCATTTGAACCTGCTTAATTACAAATCCAGTTTCTAATAATGCTATACAATTTATTGCACGCAGAAAGAAATAGCAATGTACATGGGAATCCTGAACTGCTCCTGGGAACCTTTGGGCGACCTGGAGACTCCACCTGTGCTGTATCACTAGAGTCAGAAATACCATCCAATAGAGTCGTGGGAGGTGAAGGTGCCTTCCAAACAGAGTTGGGTGACCATTCCCCGA	24	35	292	303	11
2G5Z3:05348:03089	INITIAL_QUERY	GAGGATTTCTGAGTCTAGGCCAGCCTGGTCTGCAAACTGAGTTCCAGGACAGCCAGGGCTATACAGAGAAACCCTGTCTCAAAAACCAAAATAAAAATAAAATAAAAATAAAAATAAAAATAAAAATAAAATGTCCTTGTTTGATCTGTTGCTGATGATCAGAAACTTATGATATGGGACACCAGATCCAATACCACTTCTAAGCCGAGCCATTTGGTGGATGCATCAGGGGCTCGCGCCAGCCGAACTGTTCGCCAGGCTCAAGGCGCGCATGCCCGACGGCGATGATCTCGTCGTGACCCATGGCGATGTCTGCTTGCCGAATATCATGTGAGGGGGGGTGTGTGACATTAAAGGGAAGTCACTTCATCTAGATGGAGCCTAGCATGACAATCAAGGAAGACATTCTTTTTCCTCCTTTTAATTTTAAAAAATATCCTTTTACTCTCAAATTCTGGAACTTAAGCCAGGAAA	489	578	222	311	89
2S43D:01622:06841	INITIAL_QUERY	CGTTGGGAGTCCAGTTATGTCAGGTGTGATGAAACAGGAGTGCGGAATTAGTGAGGGGTCATCTTTCAGAACTTGCTCACTGGCAATAAAATAGCTCTTGGTTCACACTCAAGTTGACAGGAGA	309	319	114	104	-10
2S43D:06101:09620	INITIAL_QUERY	CTTCACCAAAATCACTAACAACCATAAAAGTAAAAACCCCTTGAGAATTTAAAAATGAACGAAAAATCTATTTTGCCTCATTCATTACCCCAACAATAATAGGATTCCCAATCGTTGAGTCTCATGGGCTGAGGCCCTCAATCTCACAATCATGGCTGCCAAGCTGTAGCAAACACAATGCGGAATAGATGCACAAGAAGTTGAACCATTGAACTATTCTACAGTGTAATCCTTATCATAATTTGCTTCTCCCCCTCTCTAATCGCATCTCTACTGTGAGGCGGCTCCTCCATGCGTCCAAAGCTCATCTACATTTCTTTTCGCATACAGAACTCATCATTTCCTCCAAGGGCTAGCATTGAAGTCTTTTCGTAGGTCAAGGCTTTACGGGGTATCCAGCTGCAGGGAGGGGCTGTCCAGCAGGTACTTGTTGAGGAATACCATGGAAATGGAGGTGACCCAGTAGAGAGAGACCACCAGCGCGATCTGCAGAGCCCCGGAGCAGAAAATGGCTTGTTCCCGCTCTCTGACTCCTCGGAGACAGCAGAGACTCCAGTCAGCGCCATGCGCAGGATCCTGGCCGGCCTTCCAGTGCAAAATTTTTAAAAACTTTGGAAAGTTGTGGTTTTCCAGTTTGTGTACACTCACCCCCCAAATTGTAGTCTTTACAAGTCGTGTGCATTGCACCGTTGGATAAGCCTAGGGGAAAATTGTTGAAACAAATAACTGATGATTGTATGTATATATAAAGATGACCCCTCCCTTACTATTGCTGTTTCCCATCCCTCCACCGTCAACCA	349	359	148	158	10
2S43D:03927:00604	INITIAL_QUERY	GCTTTCGTCGCTATTGGGGACTACAATGGTCACGTTGGTCTTGGTGTTAAGTGCTCCACACCCATTATTTAAAATTATTAACCACTCATTCATTGACCTACCTGCCCATCCAACATTCATCATGATGAAACTTTGGGTCCCTTCTAGGAGTCTGCCTAATAGTCCAAATCATTACAGGTCTTTTCTTAGCCATACACTACACATCAGATACAATA	392	404	97	109	12
2G5Z3:09499:07943	INITIAL_QUERY	CCACTGTGGCTGGGGCCTGTGGCCGTGCTGTCTGGCTAGTGAAGCCACACTCGCCCAGAGTTTTGCCATCATCAAGGAGCTGGTCATCCTTGTAAAGCCGCTGCTCCTCTGGCGGCCGCTTGAGGATGCCTCGACGATGCGCTTCAGTTCGAACACGGTGCTCGACTCCTTGGCGTCCGTAAACGATA	41	51	112	122	10
2S43D:02378:12581	INITIAL_QUERY	CTCTGAGGAGTTAATAAATGGCTGGGAATCCAGCTGTGGGCAGCTCAGGGGGGCTGCTCTGGGCGGTAGTTAGCATCTCTAACGAAGACCTGGGCATGTAGCATAGGGGTGTAGCATAGCTGGCTCCATGGCGGCGGCTCAGAAGTCTCCAAGCGCTAGACTCACTCTGGTCCACCATGGTGCCACCCGGTTCTGGTCAATCATGTTAAAGGCCTCTTTGAACTCCTGGACTGGGACTGGTCAACATGGCGAACAGATTGGAGGTTGCGCGCTGAGGGCGCTTCTTGGTGGTCTTGGTTCTCGTCTTTTTTGCTCGACATGGTCGGCGGTTTAAATCTGACCTGATGCTGCACACCGAGAGGATCCGAC	94	104	51	61	10
2S43D:02378:12581	INITIAL_QUERY	CTCTGAGGAGTTAATAAATGGCTGGGAATCCAGCTGTGGGCAGCTCAGGGGGGCTGCTCTGGGCGGTAGTTAGCATCTCTAACGAAGACCTGGGCATGTAGCATAGGGGTGTAGCATAGCTGGCTCCATGGCGGCGGCTCAGAAGTCTCCAAGCGCTAGACTCACTCTGGTCCACCATGGTGCCACCCGGTTCTGGTCAATCATGTTAAAGGCCTCTTTGAACTCCTGGACTGGGACTGGTCAACATGGCGAACAGATTGGAGGTTGCGCGCTGAGGGCGCTTCTTGGTGGTCTTGGTTCTCGTCTTTTTTGCTCGACATGGTCGGCGGTTTAAATCTGACCTGATGCTGCACACCGAGAGGATCCGAC	406	416	283	273	-10
2G5Z3:01195:08383	INITIAL_QUERY	GAGCGCCGACTGCTCTTCCAAAAGGTCCCGAGTCAAATCCCAGCAAACCACATGGTGGCTCACAACCATCTGATACGAAGAAGAAAACCGAAGACGACAGGAGCAAGAACACCCATGCCGACCAAAGAGACCAGATTGAACAGGAAAAGAAGGAGTGAAAACGGGATGACCCAATCATCAGCACACATTTGGCCAAGCTGTACGATAACTTACTGGAACAGAATCTGATCCGGGTCATCGAGCCTTTTTCCCGAGTCCAGATTGAACACATATCTAGCCTCATCAAACTCTCCAAGGCA	325	335	97	87	-10
2S43D:08750:08664	INITIAL_QUERY	AAATGCTCAAAGATTTTTCAGAAATGATTCCTCACCATAAAAACTGAAGTCCAACAAGTATTAAATAATAGGAAAGAAATAACTGAGTTTTTTTGGGAAAAATGGTAAATACTCTTTTTGATACAGAAAAATCTTTAAAGAGCACCATCCAGAAAAAGAAAAACAAAAAGCATTGGGGCA	613	623	146	136	-10
2S43D:06390:09470	INITIAL_QUERY	ATCGCAACTCCAATGTCTGCAGCCTTGAGAGCAACTGCATCATTTACCCCATCTCCTGTCATGGCTACAACTGCCCCGTTCTTCTGTAGAGACTTAATAA	308	320	50	62	12
2G5Z3:01834:01871	INITIAL_QUERY	CACCCGTCCACCAAAATACCTCCCATTCAGATCCACCACAGCTTTAATTGCTGATTCGACTCTCTCAAATTCTAAAAATATCCGTACTGCTTCATCATCAGGGCACCAGGAATCTCAAATATCACACATTTCCCAACTTGC	169	179	97	87	-10
2G5Z3:03110:02121	INITIAL_QUERY	GTAACAGTGAGCCAGTTGTCCAAGACTTGGCTCAGCTTGTTGAAGAGGCCACAGGAGTTCCACTACCTTTCAGAAGCTCATATTAAGGGAAAATCTCTGAAAGAAATGGAAACACCGTTGTCGAGCACTTGGAATGCAAAATGGTTGCCGAGTCTGATTAATTGGTGAAAAGAGCAATGCCAGAAAGAAAGGTGGACTCATCTTGGCCATTAGGAAAAAGGACGAGCCCATTGACCTCTTCATGGTTGAGATCATGGAGATGAAGCATAAATCTGAGACAGATACAAGCTTAATCAGAGGCTTGTTTTGGATCATGGAGCTCGGCATCCTGATATGAAGAAGAGAGTGGAAAATGCCTACATCCTCACTTGCAACGTGTCCTTAGA	598	608	345	355	10
2S43D:03043:13488	INITIAL_QUERY	CTCTTTGATGTCACGCACGATTTCCCTCTCAGCTGTGGTGGTGAAGCTGTAGCCACGCTCGGTCAGGATCTTCATGAGGTAGTCTGTCACGTCCCGGCAGCCTGTTACTGAGCAGAAGGCAGAGTGGTAGGTCACTCCAAGGAGCCAGGCTTTGACCAGAGCAGGAGATGGGGCTTACGTCTTGCCAGCTCAGGGTCCCGTCAGTTGTTACAAAATAAGACATTCTGAGAGCAGGCTACACACACACACCCAGCCTAAGCTCCCCAGGTGACGGCCTTGTGCTGCAAACTGTTCATCCAGCTCGGCTCCGACTGTACTGGCGCTAAACGTGCCCACAAGGCACTGGCACTGGTTCTTTATTTCAAAATGTCACTTATCGATATTCAGTATCAAAACAGTTGCACTGCGGGGTTCTCTTTCTCCGGTCGGTCGGTCGGAGGAGAGTACAAACAAGCCAGGAATCTGCAGGGTGCCCACCTAACAGGCCGAGAAGAAACCACCTGAACATGGCAATTGGGTGGGGAA	638	648	245	235	-10
2S43D:02561:00477	INITIAL_QUERY	AAAGAATCAGGAACAGATGCTGGGGTAGAGAATTGGGTCCCTGTCATCTCACCTTGCTCCTGCCGAGAAAGTATACCAGTCATGGCTGATGCAATGGCGGCGGCTGCATACGCTTGATCCCGGGCTACCTGCGTGGGAAAAAAATTGAAATCCTGACATTTCTAAGTAATTTAGAATATTTACAGCCATGCCATTCCACTCCAGGAATTCATCTGTTAGATTCTTGGCTCAAGCTGTTACACATGTGTTATAAAA	312	347	39	74	35
2G5Z3:09933:03166	INITIAL_QUERY	CTCCCGCAGCCCTGGGTCCAGGTACAGTTGAGTGTAGAACAATTGATCATCATCGTCGTCTTTGTAGTTCCACTGGCGGACAATCTGATGGATGGTGGGAGCAAAGCCGATGAATCCACCAGAGTTGAGGAAGCGCTTCCCCATGCCCCATATCCAAGGTGAACACACACCCTGACCCACCTTTTCTCAATTTTAAATAGCAATTCTCTCTCCCTCGACCCAAGACATGTGAGCGAACTGCTAATGAAAAGCAATAAACAAGCCAACGATTAGTGGAGGGGTCCCCTTCAGAGACCCGCGGGCCGGTGGCATCGGCTCGGAGTGCCGGGTTCACAGTGCAGCTTGTGGCTCGCGTCCATCTTGCCAGGTGGCTCTTCCTCCACATCACGAGGGGGTCTTGGAGA	618	628	108	98	-10
2S43D:03335:00315	INITIAL_QUERY	GCGCCAGGCAAAGAGCAGCGCGCAGCAGGCGCCGGGCACCGAGAGGGGAGGCACTGGTGATCTCTGGCCGTCCATGCACAGAGCTCCCTCTCCCACAGGCGGAACAGCCAACCTGGCAGAGGGGATAACACACGCCGGACCCCAGCAACCCAGATCAAGGCAAGTGCCCCACCATGCACTGCTCGGACACTGGGTGCGCTACAGCTGTATCGGGTCCTGCACGCGCACAGCTGTTGTAGTTGGTAGTCCGGGCACGGTATCGGGAGCGCGGGAAACCCCGGTCTGTTGTGCTGATGCCTGGTCTGTTGGTTGTTTGGGCTCCAGCCGGGTCCATGTTTCAGCCTGGCATTCCTTGTACCGGAACTGACAGATGAGAACTTTCTGCGGTGGCCACACGGGCGGCGCCCACTGCACAGTGGCCTCCACGGGTTGCTTCCTCAGAAATATCCACTTGAGAGAAGATCTGGGGTGTGTCTGGCTTCATTTGGGCTCCAGGTTCACAGAGACAGAGGACCACAGAGGCCGTCCCTTTTGTCGCTCC	79	89	281	271	-10
2S43D:01227:01977	INITIAL_QUERY	CATTCCCCGGGAACAGTTCACCATGGCTGACAAACTCCTCATCTGGGGACACAAAGGGACGGCCTCTGTGGTCCTCTGTCTCTGTGAACCTGGAGACCCAAATGAAGCCAGACACACCCCAGATCTTCTCTCAAGTGGATATTTCTGAGGAAGCAACCCTGGAGGCACTGTGCAGTGGGCGCCGCCCGTGTGGCCACCGCAGAAAAGGTTCTCCTCTGTCATTCCGGATATGCAGTCAGGCTCTTACGTATTCTTCACACGTGAAGGCTGGTACCCCTCAGCTTGTTGGTGGGCTAATATTATTAATATAGAGTAGCTCCGCCGATTAGGATGTATTAATAAGTGTCCTGCAGTAATGTTAGCGTAGCCGGCACTGCTATGCCATTGTTGTAACTTAATAGGCTAATTT	183	193	344	334	-10
2S43D:00710:12359	INITIAL_QUERY	GAACAAGATGGATTGCACGCAGGTTCTCCGGCCGCTTGGGTGGAGAGGCTATTCGGCTATGACTGGGCAACACTTAGGTGGCACCAACCTTGACTTTCAGATGGAGCAGTACATCTACAAAAGGAAAAGTGACGGTATCTACATCATAAACCTGAAGAGGACCTGGGAGAAGCTGTTGCTCGCAGCTCGAGCTATTGTTGCCATCGAGAATCCTGCTGACGTCAGCGTTCATCTCCTCCAGGCAACACTGGCCCAGCGGACGCTGTGCTGAAGTTTGCTGCTGCCACAGGAGACAGTTCGTCCCACCACGGGATGGCTTCTCTGGCCCTGCACCACGCAAGTCTAAACTCATCTGCGAGGCCACGAACTCACTCCAAAACCGATCACAGTATCCTGGCTAAAGGATGGGAAGCTCGTGGAATCTGGCTTCACCACAGATCCGGTGACCATCGAGAACAAAGGATCCACACCCCAAACA	13	82	0	69	69
2S43D:02674:07362	INITIAL_QUERY	GCTTCCATCGTCCCTGTGCGGAGAGGCTACTGGGGGAACAAGATTGGCAAGCCCCACACTGTTCCATGCAAGGTGACAGGCCGCTGTGGCTCTGTGCTGGTGCGTCTCATCCCTGCCCCAGCGGCACTGGCATTGTCTCCTGCTCCTGCGGCACATCAAGCTGCACTCGGGTGAGAAGCCCTTCAAATCGAGGCCATCTTTCGCAACTTATGCCTGCCGCCGGAGGGACGCCCTCACCGGCCACCTGAGGACGCACTCCGTTGTGAAGACCCAGGGAAGCTCCATGTCGGGTATGTACTTAGGTAGAGTTAGCAGGCGCGTGGGAGACGCTCAGTCAGTCCAGCCCACAGCACCCGCCGCAGAGACCCATAGACTTTAGCACTCAGGA	54	64	19	29	10
2G5Z3:09794:13511	INITIAL_QUERY	TTCAGTGACAACGTCGAGCACAGCTGCGCAAGGAACGCCCGTCTGGCCAGCCACGATAGCCGCCGCTCCTCGCCCTG	201	211	53	43	-10
2S43D:03561:09822	INITIAL_QUERY	CAAGATAGCCGGCTATGTCACGCATCTGATGAAGCGGATTCAGAGAGGGCCTGTGAGAGGCATCTCTATCAAGTTGCAGGAAGAAGAGAGAATTCGAGCAGAATTAGGTCAACCAGGTGCACTTTTAGGAGATGACCAAATTTACAATGTTATCGTAACTGCCCATGCTTTTGTTATAATTTTCTTCATAGTAATTACCAATAATAATTGGAGGCTTTGGAAACTGACTTGTCCCACTAATAATCGGACCCCAGATATAGCATTCCCACGAATAAATAATATAAGTTTTTGACTCCTACACTTGAATCTCTCGTGTCTATTCCAAGAAAATGTGTCCGCTCGTGTTTCTCAGATTTCTGATATGATATTCGGAATGAGCATCGTTAGCAGCACAAGCTAAAGTGTTCGCAATGATGTCTGGGAGCCATGGCGTCGTAGTCCCGTGCACGTGTGAAAGAGCGGCCCAGCTTGGAGATCTTGCCGGTGCTTGTCATGTCAGTCAGAGTTTCTGGAGCATTCTTTTTCACCCTCGCCCTGCCAACCCTTGATCCATTTTGACATTTGTTGTGCACTATTTTTATATCTCTGTGAGCGATTTTTCCAGCAGTCAGCTATTTTATGGAGCCCATTGGTGTATGTTACTGGGTCCTACAAGGATGACTGAGTAAGGATGCTTTGCCATTATAGAGCTAGATTCTCACTGCTCTAGAGAACTCAGGAGGGAGAAAGGGTAACACTGTGTGAAGGAGTGTCTCTGCAGTGTCAATTGTTTAATTCTGTAGGGGCAGAGAGCTAAAGCCTGGCAGGATCTTAGCATTGTTAT	302	312	801	811	10
2S43D:03561:09822	INITIAL_QUERY	CAAGATAGCCGGCTATGTCACGCATCTGATGAAGCGGATTCAGAGAGGGCCTGTGAGAGGCATCTCTATCAAGTTGCAGGAAGAAGAGAGAATTCGAGCAGAATTAGGTCAACCAGGTGCACTTTTAGGAGATGACCAAATTTACAATGTTATCGTAACTGCCCATGCTTTTGTTATAATTTTCTTCATAGTAATTACCAATAATAATTGGAGGCTTTGGAAACTGACTTGTCCCACTAATAATCGGACCCCAGATATAGCATTCCCACGAATAAATAATATAAGTTTTTGACTCCTACACTTGAATCTCTCGTGTCTATTCCAAGAAAATGTGTCCGCTCGTGTTTCTCAGATTTCTGATATGATATTCGGAATGAGCATCGTTAGCAGCACAAGCTAAAGTGTTCGCAATGATGTCTGGGAGCCATGGCGTCGTAGTCCCGTGCACGTGTGAAAGAGCGGCCCAGCTTGGAGATCTTGCCGGTGCTTGTCATGTCAGTCAGAGTTTCTGGAGCATTCTTTTTCACCCTCGCCCTGCCAACCCTTGATCCATTTTGACATTTGTTGTGCACTATTTTTATATCTCTGTGAGCGATTTTTCCAGCAGTCAGCTATTTTATGGAGCCCATTGGTGTATGTTACTGGGTCCTACAAGGATGACTGAGTAAGGATGCTTTGCCATTATAGAGCTAGATTCTCACTGCTCTAGAGAACTCAGGAGGGAGAAAGGGTAACACTGTGTGAAGGAGTGTCTCTGCAGTGTCAATTGTTTAATTCTGTAGGGGCAGAGAGCTAAAGCCTGGCAGGATCTTAGCATTGTTAT	586	596	362	352	-10
2G5Z3:06565:05021	INITIAL_QUERY	CAGTTCCAGAGGTCTATGTGCCCACGGTGTTTGAAAACTATGTGGCGGATATCGAGGTGGATGGGAAGCAGGTAGAGTTGGCTTTATGGGACACAGACCACATACTTCCATAACAAACCTATTTTTCGGGATCTTTTCCAGCGTGCGGACACCCAGCCTCGGCGGGGCTGGGTAGGCTTCAAGGTTGTGTTAATTCCCACCACTGTCCCAGTTTGGACCCAGGCTAATGAGACCCATGATCTGTGGCCTTGGGCCACTGGTGGGTGGGAAGTCTGCATCTTTGGTGGGATCTGTGGATATTGGGGACAGGCCATCTGGACTTAAAGA	638	648	148	138	-10
2G5Z3:06594:14254	INITIAL_QUERY	GGACTGCAGGGCAGCAGCACTGGGGGCACGTCCTGCTTGGGGGATGGGCAGGGGGGATCAGGTCTTTCTAAGGGTTCCAAGATGCAGCTGTGCGAAGCAAAGCTGCAGGCTTGCTCAGGGTCACATTCCTTCTTGATGTGGCTGAACTTGTTCGCAGCTGGAGAAGCGAGGGATCCCGTAGTGGGTCGTTCCAAGGA	238	248	83	93	10
2G5Z3:00472:11562	INITIAL_QUERY	CTGCCTCCCATGGACACTGCACCATCAGCTCCAGATGGGCACCAACAAGTGTGCCAGCCAGGTGGGCATGACAGACGTCCAGGGACCCGGAGGCACATCTATGACACCAGCTGGCACCGACAAGTGCGGACAACTCTTCCATGTCCCGAGCAGATGGCTACAAGAGGCGTCTCGAGGAACTGGAAAGGCGGCGTAAAGAAGAGGAAGAGAGGAGACGGGCAGAAGAGGAGAAGAGGAGAGTGGAGAGGGAACAGGAGTACAGTCAGGCGGCAGCTAGAGGGAGGAGCGAGCAGGCCACCGTGGAGATCCTGCAGCAGCAGCTGCTCCAGGAGCAGCCATGTTACTGGAGTGCCGATGGCGGGA	303	313	302	292	-10
2S43D:01882:10062	INITIAL_QUERY	CCGATCAGTAGATCCTTCCACTGGGTTTGCAATTTTGATCTGCGCCCCAGACATCTGACGGATCTTCATTGATTTTGGCGCCGTGACGCCCGATTATGCAGACCAATTGCAAATCCTGCGTATTGGATTCTTTAAAAAATAAAAGGAAAGACACTTTAACGCTGTGTGTTCCCCGTGACGGGTGGGCCTGAGAGGCCAGTGTGACCCATGGCAGGCATGTATTTCTGTACAAACA	562	574	200	212	12
2G5Z3:01386:09708	INITIAL_QUERY	GGCCGGACTCGATCGTACTCCTGCTTGGCTGATCCACATCTGCTGGAAGGTGGACAGTGAGGCCAGGATGGAGCCACCGGATCCACACGAGGAGGTACTTGCGCTGCCAGGGAGGAGCAATGGATCTTGATCCTTTCATGGTGCTAACTGGTAATAAAGCTTTGGAATGGGTGCTCGCTCTATTATTTCACTACACACAAGATAGAAAGCAAGGGAAGCTGAGAATTATTCTAAAGCACAATGGAGGTTGTCATTGTCTACACCGGCACGCCTCACTCCTCTGCTGCCATTTTAGA	430	440	170	160	-10
2S43D:04798:03821	INITIAL_QUERY	CCGCCACCAAATGCTAATGAATCCATGTCTCCTTTGATAAAAACATATTATCTCCTGTCCACTTAAAGACCTCAAATTCTGGGCAGAATGTGAAAACAAATGTTTCTCCAGTACCGTAAAAAAGCCATCACTTACTTTAAATGGCTCTGATGCTAATGCACCAAAACCTGTCCATCACTGTCTTTAATCACTA	98	108	143	153	10
2S43D:00204:09985	INITIAL_QUERY	TGCAGCAGCCCACCAGCCTCACATCGCAGGTTTAGCTCCCGCTGCGTTTGTCCCAACCCATACATCATCAGCGCTGCTCCCCCAGGGACGGACCCTCACAGCTGACTGGCTGCACAGCGACACTCGGCCCAGCTGTGGTCCCTCTGAAGTTCTCAAGTTCACCCGTTAGGGAAAAGTTATTTTGTTTACATTATTATAAGGGATTTGTTATGTCTGTAAAGTGTAACCTAGACGCATCACTCCCAGCTGCGCAAAGCGTGCGAGGTGGCCCTAGAGGAAATAAAAGTGAATAGAGAAACAAAGCCCTCCTCATGGAGAAGCAAAAGCTGGATCAGGCCACCCTTCCACCCAGTGAAATTCAAAGACAAATTTTATTGAAGCAGAACAAGTGCTTCAGTTGAGGAAATGCCTCCATGAGATCAAACTGTAAGGCATTTTCTCAATTAGTGATCAAGGGGGAAAGGCCCCTTGTGGGTGGGACAATCTCTGGGCTGGTAGTCTTGGGTTTTATAAGAGAGCAGGCTGAGCAAGCCAGGGGAGGCAAGCCAGGAAGCTTTTGCCTGAGTACAAGGAGAAGGAGGTGGTGAATAAGGATGTCTTAGATGTTTACATTGAACACCGGCTGATGATGGAGCAGCGAAGCAGAGACCCCGGGACTTTAGTTGGAAGCATGGGATTTTCCTACAGTTGGT	274	284	103	113	10
2S43D:00204:09985	INITIAL_QUERY	TGCAGCAGCCCACCAGCCTCACATCGCAGGTTTAGCTCCCGCTGCGTTTGTCCCAACCCATACATCATCAGCGCTGCTCCCCCAGGGACGGACCCTCACAGCTGACTGGCTGCACAGCGACACTCGGCCCAGCTGTGGTCCCTCTGAAGTTCTCAAGTTCACCCGTTAGGGAAAAGTTATTTTGTTTACATTATTATAAGGGATTTGTTATGTCTGTAAAGTGTAACCTAGACGCATCACTCCCAGCTGCGCAAAGCGTGCGAGGTGGCCCTAGAGGAAATAAAAGTGAATAGAGAAACAAAGCCCTCCTCATGGAGAAGCAAAAGCTGGATCAGGCCACCCTTCCACCCAGTGAAATTCAAAGACAAATTTTATTGAAGCAGAACAAGTGCTTCAGTTGAGGAAATGCCTCCATGAGATCAAACTGTAAGGCATTTTCTCAATTAGTGATCAAGGGGGAAAGGCCCCTTGTGGGTGGGACAATCTCTGGGCTGGTAGTCTTGGGTTTTATAAGAGAGCAGGCTGAGCAAGCCAGGGGAGGCAAGCCAGGAAGCTTTTGCCTGAGTACAAGGAGAAGGAGGTGGTGAATAAGGATGTCTTAGATGTTTACATTGAACACCGGCTGATGATGGAGCAGCGAAGCAGAGACCCCGGGACTTTAGTTGGAAGCATGGGATTTTCCTACAGTTGGT	234	244	244	234	-10
2S43D:08836:03188	INITIAL_QUERY	GTAATCCACTTCATGGAGGAGATCGACAAGGAGATCAGTGAGATGAAGCTGTCGGTCAATGCCCGGGCTCGTATCGTAGCTGAGGAGTTCCTCAAGAATTTTTAAAACATCTAGCTGACTTGGAGTCCTTCCTGGGCCCCTCGAACCAGTACAGAAGACCTGCCCTTCCCCTCCAGCTTCCTCCAGTGACTCCTTCAGAACCAGCTGGTCCCCCAAGAAGGGAATGCGCTCTACACTGTGTCGTCTACCTGA	460	470	20	10	-10
2S43D:08162:14093	INITIAL_QUERY	GGCAGCCAAAATATCCTCGGAAGAGTGCGCCCAGGAGAAACAAGCTTGACCACTATGCTATCATCAAATTCCCACTGACACGGAGATCAGCCATGAAGAAAATAGAGGACAACAACACTCTTGTGTTCATTGTGGATGTCAAGGCCAATAAGCATCAGAGGGAGAGGAGAGGAGAGGAGAGAAGAGAAGAGAAGAGAAGAGAAGAATACTCACCGATTCTTTTTCTATCAGTTCGGTTTAGGCATGACAACTTGCTTTTGGTCTTTTTGCTGCCACACCATGACCAGAAATGGCAGCATGTGTTCGGAAGTGGGCCCTGTGTTTAAGATGTTAACTTCTTGTGTCCTCTTCTATATC	350	360	86	76	-10
2G5Z3:02175:01474	INITIAL_QUERY	CAATTGTATGTGTGTATTCTGAGCTTCATATGTCCCCTGAGCTCCTTCCAGTGACCAACTTGCAGGTGGGCCCAGGCCAGGGCTGGAGAAAAGCTCTGAGACTTGTGGGTTCTACCTTCAAATTTGGACCAAGTTTAGCTTTCTGCCCGCCTCTGACTGTGCCCAGTTCGAGGGC	74	84	157	147	-10
2G5Z3:06572:13842	INITIAL_QUERY	CCAGAATCAGGGAGGAGTACACCTGACACACAGGTTGCTCAGTTATCTTTACCAACTGCTTCCCGAAGGAACCAAGCCATTCAAATTTCTCAGAAAGAGCATCACCACGGTGTTCAACCTTGCTCCTTACTTTATGGGAAAAGTGACACATGGGCTTCCGGGAAACAAAACATCAATATTGCACTTCCCCGGCGCGGCGGGCGAGACGGGCCGGGTGGTGCGCCTCGGCGGACGTGCCCTGAGCAATAAGGAGTCCCACGTGCCTTACCGAAACAGCAAGCTCACCTACTTGCTGCAGAACTCTCTGGGTGGCAGTGCCAAGATGCTTATGTTTGTGAATTATTTCTCTCTCTGTCTGTATCTCTCTGTCTGTGTCTGTCTCGCTGTCTCTGTTTCTATCTGTCTCCCTTTCTCTCTGTTGGTCTCTCTCTAACTCTGTCTCACTGTCTCTGTCTCTGTGTCTCTGTTTCTGTCTGTCTTTCTGTCTGA	323	334	116	127	11
2S43D:03084:12854	INITIAL_QUERY	TTGAAGTTTAATGTAAATGTTCTTGGCAATGTATGTCCTTTGACAAAAAGGAACAAATCCCAGAATGACA	145	155	40	30	-10
2G5Z3:00023:10103	INITIAL_QUERY	CTAGAAGTGTGATCGCTTCCCCTGCTGAAATGCAATGCAAACTCTAGGGGCTGCTGACCTTGGGTCTCATCTCCTTGATTTTCTTTGTCCTCTTCATTGCCATCCTCTCTAGGCTGTCTTTGGCGAGGAGGGCCCCTTCGGAATCGTGGTCTGTAACCCCGATACATATTCTGTCTCACTGGTCTACCTTGCTCTCCTGCACCCTGGTTGATGCTGGAGATGTGCTCACTCTGCGGTGTCTGGTAGAACATGGAGGGCTGTGGCTCTAGTAGTCCTCCAGCAGTTGCACTGTAGGCCAGCTGTGCTTGTTCTTCTTCTCTGGTAGAGGAGGTGGCTTCTCTGTGTCACCCGTCCAACTCAGAACACTGAAATCACCCACAAACTCACACCAGAATCTGCCCCCTGTGACGTGGGAGTGAGCAGTGCTGATGGGAGCCCAGGGATAAAGGTGACCTGGAAACAAGGGACCAGGAAACCGTTGGAGATGTGGTGGACTGGGCTCAAGATGGTGAAACCAGATCTCATTACGGGTGGTTGTGAGCCACCATGTGGTTGCTGGGATTTGAACTTCAGACCTCGGAAGAGCAGTCGGGTGCCTTACCCACTGAGCCCATAACCGCATCGGAGACATCGGATTCATTTTAGCTATAGTTTGATTTTCCCTAAACATAAACTCATGAGAACTTCAACAGATTATATTCTCACGCCTCTTTGTGCTTGGAGTTCAGTAAGGCTTCCCACAGGGCCTTGGCTGAGGCCTCATTGGATGGGGCAAGGCAGCCTGGTGCAATCACGTTCTGGTTTTCCTCCACAGCCTGGACAGCAGTGAGCTCGGCCATGTTGACCATCACGTCGTGGGTGTGGCCTGGAAGCTGTGGAAGCACTGACATGCTGGAAGACAAGAAACGAGCTACAGACTGGGAGCCACAAATGAGGCCATAGAGGAGCAGGTGGCTCGAGAATCTTACCTTCAGTGGCTTGAGGGATCAAGAGAAACAGGCCCGCCAGGTCCGGGACCAGCCACCCCGGAAGACAGTGCCACATGCCAGTTCAGCCACAGCCAGCCAGCCTCCCAGTGCCTGG	239	249	296	306	10
2G5Z3:08447:07168	INITIAL_QUERY	AAGATAAGAAAACAATTTATTATAGAGAGAAGAAAAAATTTTCTCATCCAAAAATATAGAAATCTGTACAACTTTGCCACAATCAATATACATGAACTGTACAAATTTACACCAGTTCATAATTTACCAAATAAAAAGATGACTAACAAAAGTTCACAAAATAGATGGTGGTTTGTGGGAAAAGACTCTTACAGTAGCTACACGATGCATTGCGTCTATCATGTTAAACGTGCATTAGACACAAATACAAACCCATGAAACAAGCCACCATCTTTAACAGTTGAGCAAAGATAAGATGCCTAAGGAATACAGGTTCAGATCTTCCGCTGAAGTAAAGTGTCCGGTCACACAGCCGTTCACTGCAGTAGCTCTGCGCCGTACGACGTAGTTGTATCGACATATTGAGCGCCCAACCTACACCAACCTTAACCGCCTTATTAGCCAGATTGTGTCTTCCATCACTGCTTCCCTCAGATTTGATGGGCCCTGAATGTTGATCTGACAGAATTCCAGACCAACCTGGTACCCCACTACCTC	172	182	483	493	10
2S43D:01922:09252	INITIAL_QUERY	TGAATCTGCGCCCCTGATGTCACCAGGGACTGTCCCCACGAGAGCAGCCACTGGGGCTCCCTTACCCAGCTACAAGAGAATCATTCGACCTGACCATATGCCTCCAACAATCATTAGTGCCTCATGCAGG	490	500	9	-1	-10
2S43D:00057:05311	INITIAL_QUERY	GCTTCCCCTGTCCACCTTTGCGAGCCTGTTTCTGTCATGTAGTTTCAGGTGTCAGCTTCCAGTGCACACGAAGGCTGACTACTCGGGGTGAGACTTAGAAACCCAGGGAAGGCTGTGGAGAAGGCATGTGCTTTATCAGACTGACTGAAGTGACCAGGAAAAAGAAACCACTCTAATCTTCGTGCGCCAGCTTCTAGGCGTGCCTTCTCTTCCAGCTTCCTCTGCTTGTGCCTTGCTCGTTTGGCTGCCCGACTACTACTAACTGGCTTGGCCTCAGAGCTGTTATAACTGTACAATCCTCACTCTCCGATGTCACCACACACCAACCAGCATTCCAGTCCTCACAATACCATGATTTTTAAAAACCACAGCCCTAATTATTTCAGTATTAGGATTCCTAATCGCACTAGAACTAAACAACCTAAACCATAAAAACTATCAATAAATAAAGCAAATCCATATTCATCCTTCTCAACTTTACTGGGTTTTCCCATCTATTATTCGATGTAGGAGCAAGGAGAAACGGTAAGTATACAGGCCTTTCCAAGGGTCTTGAACCCGAGGAAAAGTTAAGGTCAGGTAGGAATACCTGGGGAGAGATTAGAAA	324	334	508	498	-10
2S43D:06850:06043	INITIAL_QUERY	ACAGTTATCCATGATAAAAACTCTGCGAACATACAACTTGATGTTGTTCTTTTTCTTTCTGTTTTCAAACAGATCAAAAGGAGCGCGTCTTGGGACAAAAAGAAGGGCCCGGAATTCTAATTGTCCTTCAACAGAAAAATGCTTTACTGCCAAGTGTTCTTCAGGCCGTGCATGGAGAAGGTGCCTGGGCCACTTTGGAAGTACTCTTGAAGTGTTCACTGAGAGTACGAGAATACTTCATCACTGTGTCTTTCTTACATCGAAACATCGCCATGTTCAAAAGGGACTGGCAACGCAAGCATAAAACAGCA	270	281	280	291	11
2S43D:06850:06043	INITIAL_QUERY	ACAGTTATCCATGATAAAAACTCTGCGAACATACAACTTGATGTTGTTCTTTTTCTTTCTGTTTTCAAACAGATCAAAAGGAGCGCGTCTTGGGACAAAAAGAAGGGCCCGGAATTCTAATTGTCCTTCAACAGAAAAATGCTTTACTGCCAAGTGTTCTTCAGGCCGTGCATGGAGAAGGTGCCTGGGCCACTTTGGAAGTACTCTTGAAGTGTTCACTGAGAGTACGAGAATACTTCATCACTGTGTCTTTCTTACATCGAAACATCGCCATGTTCAAAAGGGACTGGCAACGCAAGCATAAAACAGCA	143	153	94	84	-10
2S43D:02759:04350	INITIAL_QUERY	CCTTCCTCAACTCTTTCAGCTCCTCTCCACTCCTAGGTGGGCCCCTCCTTGTAGCCGACTCTCTCTTTGAAGCGGGACAGGAAGGCGGGCTCTGCGGGCCGCACATAGGACACTTGGTTCCGCTTGCTCATGGTAGTTCTGGTTCTGACCAACAATAAATAGCACTCGGCAGACTTGGCAGGGTACAAAGTGTCTGTCGCCCGCGCTA	261	271	67	77	10
2G5Z3:03875:05197	INITIAL_QUERY	CTTGGCGTGGTGCGGTTACCCTGGTCATTGGCAATAATTTCCACCTTCCATGCTGGAAGACACCCACACAGGAGTAGGTGGTGCCGAGATCAATGCCAACTGCAGGTCCCTTAGACATGGTTGCTTGTGTGTAGGCCCAGCTGCGCTGACGACGAGACCACACAAATCCAGGCAGCTGCCTCCGACAGCAGAGCCCAGCTCCAGCCTCACTTCCAGTATCCCTGCCACTCCTGTCACCAAACGCCTCCAAGTCGTGACCCCTCACAACTCATCCAAAGTCTCACTCCACA	559	569	250	260	10
2G5Z3:03875:05197	INITIAL_QUERY	CTTGGCGTGGTGCGGTTACCCTGGTCATTGGCAATAATTTCCACCTTCCATGCTGGAAGACACCCACACAGGAGTAGGTGGTGCCGAGATCAATGCCAACTGCAGGTCCCTTAGACATGGTTGCTTGTGTGTAGGCCCAGCTGCGCTGACGACGAGACCACACAAATCCAGGCAGCTGCCTCCGACAGCAGAGCCCAGCTCCAGCCTCACTTCCAGTATCCCTGCCACTCCTGTCACCAAACGCCTCCAAGTCGTGACCCCTCACAACTCATCCAAAGTCTCACTCCACA	123	133	140	130	-10
2G5Z3:00093:07578	INITIAL_QUERY	CCGGGTTACAGCTCCTATTATACATAGTACCTTGGCTTTTTGATATGCCGGGGTTACAGTTCCTAATATACATAGTACCTGGCTTTTTATTGAATGCCAGGATAAAAGAGGAGTCTTTGGACGAGGGTGTAACAGTGATTTTCTCTCCAGACCGGGCCCAGTACGGAGAAGCGTAGGAGAAGGGGCCTGGTAACGTCATCCAACCATCCTCCTCGCCAGAGCTGGGTATGTTTTTGTTATGGCATCTGTAGCTGACATGTTCAATTCACTTTGAGCTCTTCACAGAGCCAAGTGTGAAGAAAAACGTTCTGACTGTCATGAAATTTGAACACTCCACTCTGGCACGGTGCTCCCATTTTACCGCCAGGCTCGATTGAGGAGTTTCACCTGTGCCAGCCTCTTTGTGATCATGGTGGCAAAAACCAGGCCAAAAAGGACACTGCTGATGAGCACATAGTCGTAGTCATCTTTCAGGACATCAAACTGCTA	519	529	361	371	10
2S43D:06753:13500	INITIAL_QUERY	GTTTGTTGGGATTATATATGAATCAAAGCATAGGTCTTCATAGTCAGTATATTCGTAGCTTCAGTATCATTGGTGCCTATGTTTTAACGGGTTAATATCGGGGTTGTTGGTATTTCGTCTATTTATATATAAGCGAAAACCCTACCACAAGAAGCGAAAGTATGAGCTGGAGACCTGCCAAGCACAACATGGGGACTACGGCGATACACACATCGACCAAGTTAACTATATGAGGGACAATCACATGGAATGCCTCAGGAGAATGCTGAAAACTAAGCAGCATATGAGAGAGGACTGCAAGAGCACCAGGTCTCACGAGAGGAAACCAAAGTCGGTTAAAAACCAGTTCTATTTTCAGCAAAGTAACATCTATCAAAACTAGTAACTTGTCCTGCAGTTCATTCAGGGCACCGGACAGGTCGGTCTTGACAAAAAGAACCGGGCGCCCCTGCGCTGACAGCCGGAACACGGCGGCATCAGAGCAGCCGATTGTCTGTTGTGCCCACGTCATACGCCGAACTAGCCTCATCGAGGAGGTCGAGAACTGTTTGAGGAGAGACGTGC	76	86	495	485	-10
2G5Z3:09579:11463	INITIAL_QUERY	CCAACGCCGTTAGGATAGAGCAGGAGTTCCTCACGGAGGCCTTGCCCGTGAAGCTCATCGGGATGAACTGCACTTTGATGAAGCAGTACATTGAGTTTGTGGCCGACAGGCTTATGCTGGAGCTGGGTTTTAACAAGATTTTCAGAGTAGAAAATCCGTTTGACTAGGCAGCATATTCAAAAAGGTATCTGGAGGAGCAGAAGACTGAGAATGGGAAGGATGAAGGAGCAAGAAACAAACAAATGACCGAATA	179	189	62	72	10
2S43D:09637:04699	INITIAL_QUERY	GGAGACAGCTAAGCAGGCTGATTGATTCCTTTGGAAAAGCCTTGGTGGAAATTCTTGAGGAAAGTGGTTTTTGGTTGAAGAAATAAGTTGTTTCAGGAAAATTATTGGTTGTTTGAAAACTTTTGAAGCCGGGCGTGTTGGGTGCACGCCTGGCTCATACAATAAAGCCTAGAAAGCCAATAGACATTATTGCTACATACTATTCCTATATAGCCGAAAGGTTCTTTTTTTCCGGAGTAGTAAGTAAACTACATGTGAAATAATTCCAAAGTCCTGGGAGGATAAGAATATAAACTTCGTGGGTGACCCAAAGAATCAGAACAGATGCTGGTAGA	141	151	219	229	10
2S43D:09075:13728	INITIAL_QUERY	CGTGGAATGTACAGTGCATATTGGCGGCGCTCGCCTCATTACGATTCGGCCAGCTGCTTCTCTTGTTCAATTGTTCTTTAAGGCAGAGGATTTTTTCTCTTGCGTTTTCTGTTTTCTTTCTCCAACCTCTGATGAAACTGCACGAGAGAAAGCTCACAGCAAAGCTGTGATTCATGTCGTCCCCCATCCCGCTCTCCACAGCCAATGCAAACACAAGTTCTTCCTGGGCTGAGGAAGCAGAGAAAAGTAACAATTGAGCTTGTGAAAAAAAGACGACAGCGTGTGCGGTGTGATGTTTCCCCGATGTTCTTCACCTTGCGTTCTCCTCCATAGAAGATGTTTTGACATGGATTCTTCCACCTAAAATTATTCAAGATA	10	20	61	51	-10
2G5Z3:08237:03909	INITIAL_QUERY	TAGCTGCCAATGACCTGGCTTGACTGCAGCAGCCAACCTTTCACCCGTCTGTCCACGCCATGTCGGCTGCTCCTCAGGGAGCAGGAGCCATTTGGTCCCCACGTAAGTTCCAGTCTGTGCAGTCTCCTGAGGCACTGCTGTGTGGTCCTTAGGGCTCTTTTGGGTGGCCTGGCACCAACACAATTCCCAATTGTTGCTCTGGAGCATGGCA	92	102	62	72	10
2S43D:01196:10991	INITIAL_QUERY	CCAGTCTTTATCAGCTGCACATCACTCAGAATTCAATGGTGCCTCTGGAGATTTTCGTGGTGATGCCCAAAGCCTGGTTTGTTCCTGGGCCAGCCTGGTCCCTCCATCAGCCTTAGGGAAGTATAGGGAGAGGAGGGCAGGGCTGGGCTTCGTGGACTGCTGAGGATGGTGCGGAACCAGGAACTCGATGGCTGACCTGCTCTCCAGCTTCCTGCTCATTGGCGTGCTCTTCATCATCAGCATCAGCCTGCTGTTCGGCGTGGTCAAGAACCGGGAGAAGTACCTGATACCCTTCCTGACTTGATGTCTAATTTCTCATTATTTGTCTAGAAATCCATAATGATATAGGA	138	148	265	255	-10
2G5Z3:03872:01446	INITIAL_QUERY	GCTTAATGCAGATGAGATTAGTTTGAGGCCTGCTCAGTCGTTTCTAATGAATAAAAATCAGGTGCCAAAGCTTCAGCCCCAGATAACTATGATTCCTCCCAGTGCACACGCCACCACGCACTCAAACACCGCCTCCTGGGACAGACACCTCAACTTGGTCTCAAAACTATCCACCTGAAAAATAATGGGAATCAGTGAACAAATCCTGCTATGATAGCAAAACACTGCTCCCCATTGATAGAACATAGTTGGGAAATGGGCTACTACAATAGTATGTATCGTGAAGCAGCGATGTCAAGGCAAGCTTGACCACTATGCTATCATCAAATTCCCACTGACCACGGAGTCAGCCATGAAGAAAATAGAGGACAACAACACTCTTGTGTTCATTGTGGATGTCAAGGCCAATAAGCATCAGATCAAACATGCAAAGAGGCTGCAGACATGATCTTGGTGGATGATGATTTCCAACCATCATGTCTGCAATAGAAGAGGGTAAAGGCATTTATAATAACATTAAAAATTTTGTTAGATTTCAACTGAGCACGAGAGAAAAGGCTCGTATTCATCAAGAAACTGCCTTCTTATGAAAAGAAAT	350	360	346	336	-10
2G5Z3:10298:03103	INITIAL_QUERY	GGAGTGTAGGAGCTGCGAGCTCAGGGTAGCATGGAGGCTTACAGGATCCACAACTGCAAGCAGAGCCGGAGCCGCCCTGTTACAGCGGGACCCGGGCCTCTGGGGTCCAGACAGGGGTCGCCATGATCCGATTCATCCTTATCCAGAACCGGGCAGCAAGACGCGCCTGGCCAAGTGGTACATGCAGTTCGATGAGTGAGAGCAAGGATTTAAGGTAAACTTCAAGAAGCATTAGTTAATAAAATACTTTTCACTTAGGAAGAGAGGAGTTACTGCCACCTCTCGCCACGCCAACCCCATGCGGGAACTGCGCATCCGCAAGCTCTGCCTCAATATCTGACGTCGGGGGAGAGCGGAGACAGACTGACCCGGGCAGCCAAGGTGGTTGGAGCAGCTCACAGGCCAGGACCCCGGTGTTCTCCAAAAGCTAAGATACAACTTGTCAGGTCCATTTGGACATCCGGAGAAATGAGAATGATTGCTGTTCG	137	147	144	134	-10
2S43D:05381:10691	INITIAL_QUERY	GGCCTGTGATGCACCGTCGAGCTGAGGCCCTTGCTGAGCCTAGAGTCAGTCCATTGTTTACAACATATGTGGTTGTCTGAGGCACTCGAACGTGTAACACTATTTGAGGATTGACCTGGCGAACGGACTCTAGG	516	526	114	104	-10
2G5Z3:06453:12256	INITIAL_QUERY	CCTGCTTGCCAATCGCACAGCCCCAGTAACCATATGAAACACCTGATGGGTCGATCATATAGAGCTGTGCACCATCATTCGCCACTGTAAGACCCCAACATGAAAACTGCAGCCAAAAGGTCTAACCAAGGCGCTGTAGAGTGTATAGGCGTGTACATACA	578	588	0	10	10
2S43D:07726:11043	INITIAL_QUERY	GGCCGGGCCGGAGGGGGATGGCTACACCACCGGACGGACAGACAGACGCTGACGGACAGGCAGGCCGGAAGCTGTGAAAATCCACTTCCCCACGGGCTCCCAGCACAAGTACGCTGTTCTGGTTCTTTTTTCTTCCTTTTTTTCCCTTTTGCA	141	151	120	130	10
2S43D:07464:09521	INITIAL_QUERY	ATGGACCGCACCAGCTCCTGAGTTCACTGCTGCTCAGCCTGAGGTGGCCGACTGGTCTGAGGGTGTGCAGGTTCCCTCTGTGCCATCCAGCAGTCCCACGGAGACTGGAGTGCACAGCCGGCCACTGAGGATTGGTCAGCAGCTCCCAA	632	642	115	105	-10
2S43D:01856:10946	INITIAL_QUERY	GCCATAAGCTTTGCAGTTAGAGGCTAGCTTCAGCAACCTGGTGATGGAGTCAGTAGCATCTTGGTGTGCTACCTCTTGCTTACCTTGGCCAATCACAGCTGCTGGTGTGGACCATCGAGTCATCCTGGGAGATGAGCTGCCAAAATTCTACGATGAGTGACTGATCCCCAGAAGTCCCTTCCTTGTTTGTAATAAACTTCTGGAACCAGAAGGCCGGTGCGATGGGCAAAGGTGAAATATGTGTATCAGAGAGACACGGTGTGTGATGGGCGGCCTCTGCATGCCACAGGTGCTGAGTGACAGCAGCAGAGCTGACTTGGCAGGAGATCGTGGAGACCCTGCGGCAGAAGGCTGAGGCAGACAAAACGACAAAGCTGTCAAGGACCTGGTGGTGCTGCTGTTTAGAAACTGCTCTGCTCTCCTTCTGGTTTCTCACTTGAGGATCAACCCTGACCACCCCACCCACGCCATCCTCACTTTTAGACAGGACTGCGACTCGCAAAGTGGTCAATGGACCACAGTACTCAAGCCACCAGACAGGTGCTAAGCGCAACCCTACAGAGGGTCTTTGGTTGAGAATAGCTGACTGGTCTTTCA	268	278	172	162	-10
2S43D:09773:11476	INITIAL_QUERY	ACAACTTCAAGATTCTCAGCAGCCCAAACCCAAGTTCAAAGCCCCAAAATTGTGCAAGGTATTACACCACAGACAATCCCATGGCGTGCAAGCCAGTGGTCAAAAATATATCACAAACAGGCTTTTGCAAAAACCTTCAGTTTCGCAGCTGAATCCTGGAAGCCTTTTTTAATTCAAGGACAGATGTTTGGAAAGTTTATGGCAGTTTTTGAAGGCTGAGCAAGTAGGACATTCGCTGAGGGCGGAGGGTTGGAGACATCTGGTCAACATAGCAAGATGCTGTCTCAAAAATGT	84	94	68	78	10
2S43D:07215:09468	INITIAL_QUERY	GGCTTCCTGCAGATCCAGGAGATCATGGAGAAAGGCACTGAGTTCTTCCTCAAAGTTCGCTCTCCAAGTTGCGACTCCCAGGGCCTGCACCCGGAGGAGGCCCCATCCTCAGAGCCTCCAGAGCCGTGTAGCGCAGCATGGGTGGCCAGCCTGTAGCACGCCACCTGCCCGTTGTGCACGGTACTAGACAGAACAGGAGTTGGACGCAGTGCATCAGTCACATTCAGCCGCTCGTCGGAGTACAGGATGCTAGCTGAAAGACTGTGATCCCGGCTGACTGTTCCCTCGCCCACCTGGGATCGTTCAGGGGTGGGTGAGGGACATCAGGAGCACCACCGAGGCCCCGGACCCAGGTTACTACAGCAATTAAGGGCAACCCTAGAACTCTCGCTGCTGCAGCCAGCCGCGGCTGTGCTGACTAAGAAGCGGCAT	212	222	141	131	-10
2G5Z3:02512:07401	INITIAL_QUERY	CAATCTGTCAGCGCCCATCATGTCCCGCTTTGATCTCTTCTTCATTCTGGTGGATGAATGCAATGAGGTGACAGATTATGCTATTGCCAGGCGCATAGTAGACTTGCATTCAAGAATTGAGCAGATCAGACTCTCCTCGTTCGCGCAGCTCGCTCGGCTCCTTCCAGCAACCATGTCTGACAAACCCGATATGGCTGAGATCGAGAAATTCGATAAGTCGAAGTTGAAGAAAACAGAAAACGCAAGAGAAAAAATCCTCTGCCTTCAAAAAGAAAACAATTGAACAAGAGAAGCAAGCTGGCGAATCGTAATGAGCGAGCGCCGCCAAATATGCACA	10	21	278	289	11
2S43D:02516:04823	INITIAL_QUERY	ATGAAATGGCCTCTCACCTGCGGCGTTCCCAGTACTGACCTCATCTGTCCCTTCCCCACCGTTCCTTGCTTTGCACCCCTTCTTCACTACACAA	228	238	59	69	10
2S43D:02516:04823	INITIAL_QUERY	ATGAAATGGCCTCTCACCTGCGGCGTTCCCAGTACTGACCTCATCTGTCCCTTCCCCACCGTTCCTTGCTTTGCACCCCTTCTTCACTACACAA	267	277	46	36	-10
2G5Z3:02230:04801	INITIAL_QUERY	CTGCATCGTGCGCACACCGTCGGGTGCACCTGTCTCCATGGCGGCAGGTACTTTCTGACCTCCCTGGGGACCCTGATGCTTCTTGCGACTCCAAATCAGAGAATAGGAGGATTTTGTCGCCCATGATGCTTAGAGACCTAGCCTCGGCCTGAGGGAGGAAAGGCTTGCCCGAACCTAGCAAGCAGGCTGGAGTCCCTAGGTAGATCC	488	498	70	60	-10
2S43D:05092:13062	INITIAL_QUERY	GTTGAAGTCGCAGGAGACAACCCTGGTCCTCAGTGTAGCCCAAGATGCCCTCAGTGGGCCCCTCAGATGCCTGCTTCACCACCTCTTGATGTCTCATACTTGGCAGGTTTCTCCAGGCGCACG	574	585	65	76	11
2G5Z3:02346:06950	INITIAL_QUERY	CCTTGATATACTGAATACAGTCCCGACCTGTCTTCTCTGAGTCTACAATAATAGCATCCATGTTCTTCCCTAAAACCTTGGTCACAGCAATCTGATACTTCTTTTGTGTAGGCTGGCAGAGGTCAATGAGGCGGCCATACACAGAGCCAGGGTAGAGACGCTTGATGCTTTCCATTATTTCTGCCTTTCGCTGCTGGCGGCA	158	168	22	32	10
2G5Z3:10184:04549	INITIAL_QUERY	CAGTAACCTGGGCCACGTACTCCTGGGCTTCCTCTTCCTGCTGATAGTTCTGCGCAGAGACCCTTCTCCACCTCCCGGATCAGCTCGACACACCAAATGGAGCAACCTTCTAATTTCCACTTCCTGTTTATCTCCATTCAAGAGCATCTTCTCCTTTGAGGAGCTTCTTTAGTAGCTCATCTCACCAAACCAGTCCACAAACACAGAGAAAATAGCGTGGGGTATGAGCAATAATGTCTATTGGCTTTCTAGGCTTTATTGTATGAGCCCACCACATATTCACAGTAGGATTAGATGTAGACACACGAGCTTACTTTACATCAGCCAGACTTCAAATGGTCTTCCCACTTATAGCCACATTGATGACTGATAGCAAGATCATACGCTAATCTAAGCTCATGACCCCCGTTCAATCAATTCTAATAGGAGAATTATTCATTACCATATCATTATTTTCTTGACTCAAACTTTACCATTATTCTTATAGGAACTTAACATTATTATTACAGGTATATACTCAATCATACATAATTAGTTAACCCTCCCCCTTTTTCCTTTTCCTTTTCTTGTGGTTTCCGAGACAGGGTTCTCCGTATAACCTGACTGTCCTGGAACTCTCTGCCTCCCGAGTGCTGGGATTAAAGGCGTGCACCACCACCGCCGGGTGTCTCCTTTCTTA	316	326	176	186	10
2G5Z3:03565:09029	INITIAL_QUERY	TGTAAATCTCACAGGCACACACATCCATATTGCTTAGGAGGAAGAGTGGATGAGAGGAAATTTTCCTTTCACTGCTCACCATGTTGTGGCTAGTTTGTATTATCATCTTTAGCTTAAAATATAAACAAAGACTTACACATCAACATTTTCAAGGTGTTAGGCTCTCTGAAGCTGGCTCCACCAGGCTTCACGGCTGCTCTCCTTCTGTATCTCTCCATTGCTGAAGGGCTCAGGCAAGGGGCCATCCAGGTGCTCCTGGGATGGGATCACTTTGCACTTCTTGAAGAACTCATCTGTTTCCTTGTCTACCACCAGCAGCT	93	103	190	200	10
2G5Z3:01018:01555	INITIAL_QUERY	CTCAACACTCTGAGCAGAGTAATGGATATTTATTGGAAGCTTTGTGAGCTAGCCTGATGACGGCCCCTTCTCCCGGCTACCTGCCCATTCGACCACCAAGCGAAACATCGCATCGAGCGAGCACGTACTCGGATGGAGCCGGTCTTGTCGATCAGGATGATCTGGACGAAGAGCATCAGGGCTCGAGCA	388	453	72	137	65
2G5Z3:00519:05406	INITIAL_QUERY	TTTATTTTCAAAATCTAATATTTTAATGTCAAAGAGTTTAATAAATGCTTTATAGTATCTTAAAGGGATCTACTTATTGGCTTATAGATTAATCCTAAAACAGCTACCTTATTAGAAAAGGGAAAAACAGGTTTTCTCCACAGAAGACAATCGGCTGCTCTGATGCCGCCGTGTTCCGGCTGTCAGCGCAGGGGCGCCCGGTTCTTTTTTGTCAAGACCGACCTGTCCGGTGCCCTGAACTGAACTGCAGGACGAGGCAGCGCGGCTATCGTGGCTGGCCACGACGGGCGTTCCTTGCGCAGCTGTGCTCGACGTTGTCACTGAAGCGGGA	180	271	240	331	91
2G5Z3:02303:14481	INITIAL_QUERY	GAACCAGTGAAAGCCAGTGAAGCAGCTGTGAAAAAAGACCCAGCCAAAAGGCCAGACTGACCGATCCCATTCCCACCACAGAGACTTCAATCGCACCCCGCCAGAGGCCTAAACGCTGGGCAGACGTCACCAAACCCGGGAGACCGAGGAGCTGCATCACGACAGGGTGACCCTGGAGGTGGGCAAAGTGATCCAGCGGGGCCGGCAGAGCAAAGGCCTGACCCAGAAGGACCTGGCCACGAAAATCAATGAGAAGCCGA	214	224	232	242	10
2S43D:03966:13371	INITIAL_QUERY	CACCTAGCACGATGAAGATTAAGATCATTGCTCCCCCTGAGCGCAAGTACTCAGTCTGGATCGGTGGCTCCATTCTGGCCTCACTGTCCACCTTCCAGCAGATGTGGATCAGCAAGCAGGAGTATGATGAGTCAGGCAGCTTCGTGCTTCACAGGACTGAATCCTCGGTAGTGGTTGAGGAGTCACTCAAAAAGAGAAGTAGAAATACACAGTGACCGAAGAACTGCAGGGGAAGAAAGTTGAAGCTAGATAGTTGGCAGTTAGGAGGCGAAAAGCTGCCTCGCTGGTATACAGAGCGCGCCTTGGGCACGGCAGGGAGAACATGCCTTTCTAAAGCAGAAAGTCTTTTCGGTTAGTGGGGTAAGGAAAGGAGGATAACACGAGAAAAGCCAAACCTAAAGCCCAAGCACCGGGCTCGGTTAGTGCCCACCGACGTCATCATTTACAGTATATACAAATAACAGTATTACAAGGAAGAAATACTCAGTCTCCA	181	191	220	230	10
2S43D:03966:13371	INITIAL_QUERY	CACCTAGCACGATGAAGATTAAGATCATTGCTCCCCCTGAGCGCAAGTACTCAGTCTGGATCGGTGGCTCCATTCTGGCCTCACTGTCCACCTTCCAGCAGATGTGGATCAGCAAGCAGGAGTATGATGAGTCAGGCAGCTTCGTGCTTCACAGGACTGAATCCTCGGTAGTGGTTGAGGAGTCACTCAAAAAGAGAAGTAGAAATACACAGTGACCGAAGAACTGCAGGGGAAGAAAGTTGAAGCTAGATAGTTGGCAGTTAGGAGGCGAAAAGCTGCCTCGCTGGTATACAGAGCGCGCCTTGGGCACGGCAGGGAGAACATGCCTTTCTAAAGCAGAAAGTCTTTTCGGTTAGTGGGGTAAGGAAAGGAGGATAACACGAGAAAAGCCAAACCTAAAGCCCAAGCACCGGGCTCGGTTAGTGCCCACCGACGTCATCATTTACAGTATATACAAATAACAGTATTACAAGGAAGAAATACTCAGTCTCCA	528	538	295	285	-10
2G5Z3:01153:11947	INITIAL_QUERY	ACCTGCAGTTCATTCAGGGCACCGGACAGGTCGGTCTTGACAAAAAGAACCGGGCGCCCCTGCGCTGACAGCCGGAACACGGCGGCATCAGAGCAGCCGATTGTCTGTTGTGCCCAGTCATAGCCGAATAGCCTCTCCACCCAAGCGCCGAGAACCTGCGA	30	40	150	140	-10
2G5Z3:07976:06710	INITIAL_QUERY	GGCTGGGTGAGCTCAGGAACTGTCAGGGCACGGTACTCCTGGCTGCCCGCCTGGTCAAGGGGCAAAGCCAGGGCATGAAGAAGTGCAGGACGAAGGGAAGGGCACCATAGTTTACAGCGTCCCCCACCTGCAGCAGCACGTCCTCGCAGCTTCTTCTCCCGTCCGGCGACCTGCTTGGAGGCTGGCCTGGCGCCTCCCTGGGTAGGAGAGAAAGCTGACTGAAAGGGGGCACCCTCCACAGATAGCTCAGCCAGCAGATGGGCTTACGAGCTGCTACGAGGATGGAGACCCTACGATATCCACTCGAGCAATGCTGTGGAGTCGCTGGTTCAGCTGTTCAGCACTGTGAGTGTCCAGTACGTGCCCACCTGGTCCAAGGAGATGGTAGCCCTGCTGCGAAGCTCCTCACCGTGAACCCTGAGCACCGGTTCTCCAGTCTCCAAGACATGCCAGACACGCCCCA	185	195	83	93	10
2G5Z3:08679:04516	INITIAL_QUERY	GCATTTGTGCCTAAGCCTGGCTCCCTGAAGAGAAGTCTGGCTTCCCAGAGCTCAGATGACCACTTGAACAAACGGTCTCGCACCTCCTCTGTGACGCTCCCTGGCTAGTCGCGTGCACAGGAGGCATCCCCGACTCCAGAGACGACTTCACAGAGGAACGCCTGGCCAAGCTGCAGGACCCCTTCTCTGTCTACCGCTGCCACACCATCATGAACTGCACACAGACCTGCCCCAAGGGTCTGAATCCGGGGAAAGCGATTGACGGAAATCAAGAAGATGATGGCGACCTACAAGGAGAAGCGAGCA	179	189	209	219	10
2S43D:09714:10602	INITIAL_QUERY	CCGCGCACTGCGCCCCAGCACTAGCCGCAGCCTCTATTCCTCCATCCCCCGGTGGCCGCTATGTGACCCGGTCCTCCGGCAGTGCGCCTGCGGAGCAGCGTGCCGGGCGTGCGGCTGCTTCAAGACTCGGTGGACTTCTCGCTGGCACTCCGGAACAAACGTGAGGTTTGGAGGGTCAAGTTTACCCTGGCCAAGATCCGTAAGGCGGCCCGGGAGCTGTTGACGCTAGACGAGAAGGATCCCCGGCGTCTGTTTGAAGGCAATGCTCTCCTGCGGCGGCTTGTTCGCATTTGGGACACTGTTCCATGCAAGGTGACAGGCCGCTGTGGCTCTGTGCTGGTGCGTCTCACTCCCTGCCCCCAGAGGCACTGGCTTCTCTGCTTCCTTGTGCCCAAGAACGCTCCTGATGATGGCCGGTATAGATGACTGCTACACTTCAGCCAGAGGCTGCACTGCCACCCTGGGCAACTTTGCTAGGCCACCTTGATGCCATCGTCCAACGGGAGAAACTGGGCCTGACCCGGATTCGGGACAAGGAACTGGTATGTGCAGCCCTCCTGTGCCACCTCCGGGGACGGACTTCTATGAGGGCTCACATGGTTAACCTCTAACTACAAATCCTAATGAGCGTCCTCCACCCAGCCCCG	365	375	271	281	10
2S43D:10079:08549	INITIAL_QUERY	GCCATGACAGAGGAGGCAGCTGTTGCAATCAAGGCCATGGCAAAATAACCGGCTTCCAGGGTGGCGGTGGTGGCAGCAGTGATCCATGAGCCTACAGAGGCCCCTCCCCCAGCCAGGTTCTGCTCTGGCTGGGCCCTTGGCTGGACTCCTATTCAAATTTATTTGTACTGTTTTATTT	449	459	48	38	-10
2S43D:03895:10153	INITIAL_QUERY	GTCCTGCTTGCTGAGTTTTCTGACTGCACCAGCTGATACAGTAAGTGGCCCATGTGGTCCCTGGTGATCTGGCTCCGATTCCACCCAAAGTAACAGAGAGAAGATGACGCAGATAATGTTAAACCTACAATTAACCCCAGACCATGTACCGTGCCACTTCAGGCGGTGCTGTCCTTGTATGCATCTGGGCGCACCACCTGGCATTGTCATGGACTCTGGTGACGGGGTCACACACACAGTGCCCATCTATGATGTAATTGCTGAACTTAAGAAACAGTCTAAACCTGTGACAACCCCTGAAGAAATTGCTCAGGTTGCTACAATTTCTGCAAATGGAGACAAAGACATTGGGAACATCATTCTGATGCAATGAAAAAGGTTGGAAGAAAGGGTGTCATCACAGTGAAGGATGGAAAACCCTGAATGATGAGCTCGGCCCGCTCCCATTCCGGCCTTGGCTGTCAACTTTAGCCTCCTTGGATATCTGCTATCAACTCCTCGGTTGGGTAGTGTCGTCTCTGCTACTGATGGTGGCAGCAGTGGGTGGGAGCACGGGGGCTTCAGAAGCTGCGGTTCTCCAACTACCGGCCGTTCGAGCCCAGACACTGGCTTCAGCCGAGCTGGCGGCTGACGAGCTTCTCCGGCATTGAAGGGGCCCATGGCTGACAAACTCCTCATCTGGGGGACACAAAAGGGACGGCCTCTGTGGTCCTCTGTCTCTGTGAACCTGGAGACCCAAATGAAGCCAGACACACCCCAGATCTTCTCTCAAGTGGATATTTCTGAGGAAGCAACCCTGGAGGCCACTGTGCAGTGGGCGCCGCCCGTGTGGCCACCGCAGAAAGTTCTCATCTGTCAGAAAACCTTTCCTCCCCTAAGTTCCTTTGGTCATGATGTTTATCACAACAACAGAAAGAATTCAAGGAACAAGGAAAAAAGATATTTGTGTTTGGTTTCATTTTCCTGTAGCTGGGGATTTAAAAAAAAAAAAAAACTGGAGGCGGAGGAGACGCCTTCAGGGCCCAGGCCCACAGGACTCCTGAGCACCGTGGGAGGCATTCCATCCGCTGTGTGCTTACTGCCTCCACTGTGCATGTGCAAATACTTGTGGCTGCTGAATCAGAGGAAGGAGCTTGGAGACAGGAAGAGTTTATACGCAATGTGAAGGTGACGAGGTTGAAGATCTCTATGAACTGATTGAAACTGTTAAAGGAAAAAGAAGAAATCAAGGGGTATCAGTAGTGCTATACTCTCGACTATCAACGTGGACGAGTAGAAAAATGTATGTAAACGACTCAATCTCCACCTTTAGCTTTATCTTTGGCAAAGAAACCAGA	356	367	361	372	11
2S43D:03849:14427	INITIAL_QUERY	CCCCAATGTGTCCGTCGTGGATCTGACGTGCCGCCTGGAGAAACCTGCCAAGTATGATGACATCAAGAAGGTGGTGAAGCAGGCATCTGAGGGCCCACTGAAGGGCATCTTGGGCTACACTGGAGGACCAGGTTGTCTCCTGCGACTTCAACAGCAACTCCCCAGGCAGGATGATCATGTCCCTCAGGTGCGTCTTCACCACCTCAGGCTTCTCCATGGGTGGTGCCTCCTTTTTGGCCTTTCTCAAGCGCTTGAGCAGTGAGAAGAAAGGCAATAGTGCTGAAGCTAAAGGCAACCGAATGGCGGACCAGGCAGCCCGGGAAGCAGCCATGGGGACTGACACAAAGGCCTCCTCACTTCTCATAGAGACCTCAACA	469	479	166	176	10
2S43D:03849:14427	INITIAL_QUERY	CCCCAATGTGTCCGTCGTGGATCTGACGTGCCGCCTGGAGAAACCTGCCAAGTATGATGACATCAAGAAGGTGGTGAAGCAGGCATCTGAGGGCCCACTGAAGGGCATCTTGGGCTACACTGGAGGACCAGGTTGTCTCCTGCGACTTCAACAGCAACTCCCCAGGCAGGATGATCATGTCCCTCAGGTGCGTCTTCACCACCTCAGGCTTCTCCATGGGTGGTGCCTCCTTTTTGGCCTTTCTCAAGCGCTTGAGCAGTGAGAAGAAAGGCAATAGTGCTGAAGCTAAAGGCAACCGAATGGCGGACCAGGCAGCCCGGGAAGCAGCCATGGGGACTGACACAAAGGCCTCCTCACTTCTCATAGAGACCTCAACA	574	584	77	67	-10
2S43D:04923:13813	INITIAL_QUERY	GGCGCAAGTACTTTGGTACGGTGTCTGCAATCTCAACAAGGGATTTTAGGACCGAGTCATCATTCTGGTAGCATGAGTCATTGACAGCCTGTAAGAATCCAGGCAGCAATCTGCAAAGTTGTTTGAACAGAGCGACATTATGCTCATTGGCAAGTATGAAGGCAGCAGTAGCTCTGGCAGACAGTGTCCTGATCGAAGGATGCTCCTGATCTAGTGCTTGAGTTCTTAAAAGTGTTGTGCATATG	464	474	186	176	-10
2G5Z3:01441:09271	INITIAL_QUERY	GACTTGTACATTGTTTGTTTTTTTTTTTGGTTTGTCTTTTTATTAGTCATTCCAAGTATCCATAAATAAGTGTAGTAATCAACCATTTGAACTATTCTACCAGCTGTAATCCTTATCATAATTGCTCTCCCCTCTCTACGCATTCTATATATAATAGACGAAATCAACAACCCCGTATTAACCTTAAAACCA	341	351	53	63	10
2S43D:03583:01985	INITIAL_QUERY	GGGGTGTTGGTCCTTGGTCTCACGAGGCCGGCTCTAGGATGCATGCCTTGCAGAGGAAAGCTGCCTTGCTGGCTAATCTGACCCATCATAGAGTTAAACGATGGTGACTGTCCCTGAAGGTTAAGACGATGGGGCCAGCAAGAACAGGAGTCAGGCCACCAAAGGACAGGGTATGGGGTGAAAATACAGAGACCAGAGCTGGACTGGGCTGACCACAAGAGCCCAGCTTCGACGGGCCAGAGAATAGAAATTCTTACAGTGCCAACAGAAGTATTACAGTACAATTTTCCACAACAAAACTGGAGCACACAGTCCATGGGAATCTCGACTTCCTTCAACTGTCAACACACTGCACCCTGTATAAGTGGACTGATAAGGACCTGCCAGCAAACTTGGCTTTGCTGCCCAGCTCTTCCTCAATTCTGAGGATCTGATTGTACTTGGCCAGGCGCTCGGATCGGCAAGGGGCACCAGTCTTGATCTGCCCAGTCGCAGAGCCCCACCACCAGGTCTGACGATGAAAGTGTCACTGTTGAAGTCGCAGGAGACAACCTGGTCCTCAGTGTAGCCCAAGATGCCCTTCAGTGGGCCCTCAGATGCCTGCTTCACCACCTTCTTGATGTCATCATACTTGGCAGGTTTCTCCAGGCGGCACGTCAGATA	574	585	595	606	11
2S43D:03379:00858	INITIAL_QUERY	TCGCTCTGGCTTCTGGGTACCAGTTGGGTGGTATCCTCAAGTCACTGATTTTACGTAGATCATCCTTGCATTCCAATACAGA	470	480	56	46	-10
2S43D:01767:08921	INITIAL_QUERY	CATGCCTCTCGCAAAGGATCTCCTTCATCCCTCTCCAGAAGAGGAGAAGAGGAAACACAAGAAAAAGCGCCTGGTGCAGCAGCCCCAATCCTACTTTATGGACGTGAAATGCCCAGGATGCTATAAAATCACCACGGTCTTTAGCCATGCACAAACGGTAGTCTTGTGTGTTGGCTGCTCCACTGTCCTCTGTCAGCCTACAGGTGGAAAGCAAGGCT	305	315	14	24	10
2S43D:09771:03039	INITIAL_QUERY	GGCAGCTGTGCGTAAAGGCGCTGCTGGCTTCCGGAGATTTTTCTCTCCCTCCGTGGTCGCGCCTGCTTCTCGGCGTCCGCTTCCCTCAGTTCCCCGCTCCCAGCAGGA	238	248	1	11	10
2G5Z3:01778:13784	INITIAL_QUERY	CCCTCGGCTCCTCCGGCGACTCCCCGTCCGTGCTCATGCCGCCGTCATGCCAGAGCAGGTTCGAGCGCTCCAAGACACTGGCGACGCCGCCACTGCGGCGGCGGGGCCCGAGCCTTCGACTCGGGCGTCCGCGA	104	114	35	45	10
2G5Z3:03567:01143	INITIAL_QUERY	AAGTTAAATAAGGCAACGCTTAACTGAGGTGATCAAATGATTTTCTCATCCGTAGATGAGTGGGCTTTTAACCTTGGCTTGGGTGGACATGGACCCGATTCCTCCCCGTGGGTACTGGTAAAACCCACACATGTGGGCAGACCTTTACCTGTGAGCCCCTAGGCCAAGGCTGTAGCATTAAATGACTATTTATTCTTCTGCCCCCCTCTAGAGCACTCTTCTTGGCCAGACCCTCTGTCCAAGGCTCATTAGAAGGCTGGGGTTGTGTTCAGGA	46	57	76	87	11
2S43D:08607:13613	INITIAL_QUERY	CAGCTTCATAACACAATTCTTCTTTTACAATTTTAACAATATAACTTCTCCCGTTCAGAATAAATATACACCCAATGTATGGAGCAGGATTCAAAGTGGATAGTGGTGTGGGGGCGCTTGTACAGTGTTTATCGCTTGGGGACCTGGAGTCCTGGGGGGAGGCAGTGGTGGTCTTCTTAGACATGGTTGGGATTTTATTGCTGACAGGGTTATGGGCTGTGCATGTGAATGTTGGGCAGGTGTTCACCACTTTCCCAGGAGACGTTGAGGTGCGACTTCCCTTGGGACATGACAGCTTTGTTTTGTAGAGGCATCCATGTGTATGTCACATTGTTTTCCACCACCGTCCACTGAACAGGTCAGGACAACCTCGCAGATTCCGTTCATCATGTGCACAGGACTCTTGA	596	606	333	323	-10
2S43D:05740:09047	INITIAL_QUERY	GATCCGAGCCCCCTCAGTCATTGACACGCAACAGACATTTAAAAGCACGCTTCCCCCCAGTAGTCAAGGGGAGCTAGATGCCAACACGAAGGAGCCCAGGGTGACAGGAGA	309	319	101	91	-10
2S43D:10241:04590	INITIAL_QUERY	GGCGTATGTATCAGTCTCAGTCGGGGGTGAAATTCAGTGTGGAGCCAGGGATATAGAAAGTACCAGTTCCTTGCTGAAGGACATATCTTGACGCTAGAACAAAAAACAGATTTTGGGCAACACTATTTCAGTAAAGATCAAACTATGTGCAAAGAGTGGATATTATTTTTTTTCTTCTGATTATGAGGAGTCGTACTACTCGTCTTGACGTTGTCAGCATTATATTGTAATCTGTGCAGTAGCTAAAGGAGAATCCACACTGTTGCGGGGACATCCAAACATTCCTTGGTTTGTTCTCTACTGTTAAAATGTGTATGAATTTAAGTTGCGTGTTTAATAAAAGGCTACAGACGTAACTCGATCAACACAAGGAAACTATACTGCTTTAATACATTCTGCTGA	250	260	206	216	10
2S43D:03578:00714	INITIAL_QUERY	CTCATCACTGCAGGAGCACAGCTGGTGGAACTGGACCTCAGTGACAACGCATTTGGACCCGATGGAGTGCGAGGCTTCGAGGCCCTCCTCAAGAACCA	239	249	14	4	-10
2S43D:09707:09569	INITIAL_QUERY	GGACGCAGCCAACCTCAGAGAGACATTCATGGGCCTGAAATACCAAGTCAGGAATAAAAATGATCCTTACTCGTGAAGACATTTTGGAATTAATGGATAGTGTTTCTAAGGAAGATCATAGCAAAAGATGCAGATTCTCGCTCCCTGGAGAGCCTGGAAGACACTGGATCCTCAGAGAGACAAGGCGCGTGCTGACAGCCTAACCACCTGTCCAGGGTAGGGATGCTGGGAACATGAATACTCAATCACAAACATCGTAATGGGATCTGATGCCCTCT	119	129	190	180	-10
2S43D:05242:12330	INITIAL_QUERY	GAGAGAGAGAGAGAGAGAGAGAGAGAGAGAGAGAAGAAGAGAGAGAGAGAGAGATGACATGCCTGCGCAGCTGGTGGACAAGGATAGGCTGGCCTGGACCCGTGCATGTACAGAAAGGTCCTTTTGGGCGGGAAGAAGGTGAGAGTTTTCTGGCCGTTGACTTGAAATATATTTTTGAGTTTTGTCCTTCATGTTTTACGGAATAAAAGTTTGGCA	235	245	63	73	10
2G5Z3:09580:10537	INITIAL_QUERY	TCGTCCTTCATGCCTCCTCTACCCCTGGAACGACCTGAACCTCTGTCTTCGACCAACTGAAGCAACTTGGGATTAATTGCTTGATTAGCTTCCCGAAGCACAGAGATAAGGTCGCTCACTTGCTTTAACTCTTTGCAAAACATCTCGCCATTCATTGATGACTTCCTTCCAAGTTAGCATCAGCCAGTAATTTCTTCACTGTCCAGTCTTCCAGACTCTTCCTCTCCCACCCTGAGCTCAAGTCATTGGAAGGTACCATGTTGCCCCATTCCTGTCCTAGATATTGTTCTGCATGAGATATTTAAATATCATTTTTCCTACAAAGTTCTCTATACAAAGGCCTATTTCTCTTTAAAGGGGCTTTGCAACCATACTCCCCCCGGAACCCAAAGACTTTGGTTTCCCGGAAGCTGCCCGGCGGGTCATGGGAATAACGCCGGCCGCATCGCCAGTCGGCATCGTTTATGGTCGGAACTACGACGGTATCTGATCGTCTTCGAACCTCCGACTTTCGTTCTTGATTTAATGAAAATCATTTCTTGGCAAAATGCTTTCGCTAGGGGTCTCCAATATTTTTACAAAAATGCAGCTTTAACTTGGAATCCAAACATCTCTTTCTTTCTGGACAAAGTACTCATCCACATAGGCATGAGGTTGGGCCAGTAAGCTGACAGTGGGACAGGAGGCCAGGAGCAAAGAGCAGCATTACAATGTCGGGA	353	363	176	166	-10
2G5Z3:07440:12356	INITIAL_QUERY	CTATATCAATTACAGAACTCTACTCAACTTAAACTTCATAATAGAAGCTCTACTTACTATCATTCAAAGTGCTGTCACTGTGTGGGTGGAGATAGCCACCCGTGCGGGGGGACCCGGCCAGTGGTCCGTCTCAATCTTTGGTATCTCGTTGGGATCTGGCGCCTGGGCTGCTGGGAACTTGGAAAACTTGTGATATCTTCTGAAGCCTTGCTCTGGGCTGCCAAGGCAGCATGCTGTTTGATAGATGACCCCTTCTTTTGTTGTGCTTCAGGAAAATCCAATTTTCTTTGGTTAATCTTGGATCGGTTCGGTGTTGAGTTACCTGAACATTCATTCTTTGTGGTCCCATGTTCTGATAAGATCCGTGGCCAGGAAATCTGTGA	49	59	82	92	10
2S43D:08135:11039	INITIAL_QUERY	AAGCCAGAGCCGCACACCTGCATGGTAGACCTTCTACCGCTGAGCTGTGCCCATGATTAGGGATTTTGTTTGCCAAAGCATAATAATTTATCATTTTATTATTTAAACACCAACACCGATAAAGCGTGGGCGGTCCTGCATCCTCTTGTGACCCTGGCACTCAGCTTGGAGGCTATCCCGGCACATCATAGGCTATCATTAGAGCTGAGTACTGACAAAAAGATGGGTAAAAT	144	154	213	203	-10
2G5Z3:09529:01505	INITIAL_QUERY	AATTTACACTGCAGCTTTCGTTTCTGAGTACGAGGCCCCCTCTGGATGCTGGTCTTCATTTTCTCTGTCAAGTGCACGACGTTGGACTGCAATCTCCGATATCAAATGGCTCTTCAAAGATGTAGGCAGCATCAGCTCCTGCTGCAAGAGTGGCTCCCCAGTGAGTTTGAGGCCACTGTGGTCTAAATAGTGAGTTCTAGGACATCCAGGGCTATGCAGAGAGATCAAGTGGGTTTGTTTGCTTACTTGTTTGTTTTTTAATGGCGGAGTACGACCTGACTACTCGCATCGCGCATTTTCTGGATCGGCACCTGGTCTTTCCGCTTCTTGAGTTTCTCTCTGTGAAAGAGATTTATAATGAAAAAGAATTATTACAAA	613	623	295	305	10
2G5Z3:05165:10357	INITIAL_QUERY	CTACATACTGCAGGACACTTATTAATACACGGGCCATCCACAGTCTTCTGGGTGGCAGTGATGGCATGGACTGTGGTCATGAGCCTTCCACAATGCCAAAGTTGTCATGGATGACCTTGGCCAGGGGGGCTAAGCAGTTGGTGGTGCAGGATGCATTGCTGACAAA	183	193	6	16	10
2S43D:07929:08220	INITIAL_QUERY	CTAACATCCACCCAAGTGTATCATGGGATATGCATATCATGCACACATATACAATAAAAATTTTTCTTAATGAGAAAAAGAAGGTTGATACAACCATTATAGAAGAGGCTATCATTCATTTCCTCCCTGTTATTAAATTCTAAATTAACGTTGACCTTCTCATGGGGGGCCTTTTTACAGGCTCCACCCCGCAATTCTGCCAAAGCCAAGAAATAGCCTCCATGTGCTGCCCTTCTGCCCCAGATCGTTTGTACAGAAATCATGCTGCCATGGGTCACACTGGCCTCTCAGGCCCACCGTCGAGCCTTCATTTGGTTTCGGATATTAAATTCTACTTTTCGACTCGGTCTTTGAATTTTAGGAACTAAGCTTCCGGACTGCAGTTCCTCATAGCCACAGTTTGCAAAAAGTGCAGCTATTGATTAATGCAATGTAGTGTCAATTAGATGATACATTCCTGAGGTCTTTTATCTGTTGTTCTACTTTGATCTTTTTCTTTTTCTTTCTATTAT	47	57	6	-4	-10
2G5Z3:07883:09404	INITIAL_QUERY	GCTAGCCTGTGGTTCTCCAAGGACGGCTTCAGTGGGATAGAGGATGATGCTGACGAAGCCTGGAGATCAGTCAGGCACAGCTGCTGTACAAGAGCCGTCAGAAGGAGCAGCAGGCCAACAGACCACCTCCACCACCTACTAACTTGAAGACTGAGAGAAATCTCCCAGGCCAGAATGAGTCCCTAAGGAGACAGAAGCCATCT	238	248	74	64	-10
2S43D:02882:04925	INITIAL_QUERY	CGGAGCCGCCACCCAGACACTGTCGCACGGGAGGCGGGATCCGCACGAAATAAATCATAATGAGTTATGCAGAAAAGCCGGATGAAATAACCAAAGATGAATGGATGGAAAAAGCTCAATAACTTGCATGTTCAACGAGCAGACATGAACCGACTCATCATGAAAGTCAAGAAGGCGATAGAAGGCGATGCGCTGCGAATCGGGAGCGGCGATACCGTAAAGCACGAGGAAGCGGTCAGCCCATTCGCCGCCAAGCTCTTCAGCAATATCACGGGTAGCCAACGCTATGTCCTGATAGCGGTCCGCCACACCCAGCCGGCCACACGTCGATAGTTCTCAGTGGTTCTCAGTCTGTAGGTCAGACCTTCCTGGGTGCTCGGTCAAAGAGACCTTTTAACAGGGGTCACATAAGACTATCACAGATATTTACATTATGAA	631	641	314	304	-10
2G5Z3:08932:01662	INITIAL_QUERY	GGGGACTCAGAAATGGGTGGCGGGGGATGGCACTGTTAAGCCCATACGCAGCAACTTGACAGTGGGACAGGTATTGCATGAGATTCCAGAGCCTGGCAGCAGGTGAGATGAATGGGCACAGCAGACCCAATGCAGGACTGT	316	326	101	91	-10
2S43D:03956:06632	INITIAL_QUERY	GCGGCAGCCGCAGCCATGAGCAGCAAAGTCTCACGCGACACCCTGTACGAGGCGGTGCGGGAAGTCCTGCACGGGAACCAGCGCAAGCGCCGCAAGTTTCTGGAGACGGTGGAGCTGCAGATCAGCCTGAAGAACTACGACCCTCAGAAGGACAAACGTTTCTCGGGCACCGTCAGGCTCAAGTCCACCCCACGCACCGAATAAGAGCAAAAAACACTGTTATTGACTACTGGGGGGCTACGGGCGAACCTACTTCAGTGTACATCTGACCCATAACCACAGAGTTGAAGTTAAAGTGAAGATCCCTGAAGAGCTGAAACCCTGGCTTGTGGATGACTGGGACTTGATCACCAGACAGAAGCAGCTTTTTATCTTCCTGCAAGAAGAATGTGGATCATTTTGGAGGATTTATGCAAATTATAAGAAGATCTCGAGGAAATACAGATAATAAAGAGGTGCTTTCAAGGCTTTTAACAACTTGTCTGCCTTCATGTTAGCCCCGGAGGCCCAGCCTTTTTGGCTAAATTTTTGCAGGTCGCTGTACTTAAAGGAGTCCAGCTCCTCTGCAGAGGGGACGGTCATCGCGA	522	532	173	183	10
2S43D:09715:03197	INITIAL_QUERY	GCCGGCCATCATCAGGAGCTTCTTGGGCACAGGAGCAGAGACAATGCCAGTGCCTCTGGGGGCAGGGAGAGACGCACCAGCACAGAGCACAGCGGCCTGTCACCTTGCATGGAACAGTGGTGGGGCTTGGCCAATCTTGTTCCCCCCAGTAGCCTCTCCGCACAGGGACGATGGAAAGCTTGGCCAAGATGATGGACCCCTCGGATCGGCAGTGGCAACC	54	64	149	139	-10
2G5Z3:02265:13183	INITIAL_QUERY	GTTGTCTGTACCCTGTTGTGGCTCTATAAACAGGTCTTAGAGCCTTCTTTTCGCCAGGCCTTCCCCAATACCAACCGGTGGTTCCTTACCTGCATTAACCAGCCCCAGTTCAGGGCTATCTTGGGGA	517	527	49	59	10
2S43D:06803:08183	INITIAL_QUERY	TTTCATCATTATAAATCCACATTCTCTGTCACCATCACTTTTCCATCATAATTTTTTATTAGTTCTTCAATGAAAGTGGACCATCCTGAATCCAGAACTTCATCCCCCATATAAGGAATGTTATGTAAAAACAGTTTCGTCTTACCACCATAAAATTCTGTTGTAAGGGA	615	625	87	77	-10
2G5Z3:07487:04318	INITIAL_QUERY	CTGGGTTAGCCACCAAGTTGAGGAAGAACTTGGAAAATTTTTGATGTCATCGTCAAGCTTAAAAAACAGCTTTAAAATTCTTAAATTAAAAATGAATAAATAGCCAGACAACTTTCCTTCTAGGTTACTCTCAGATATGGTGTGGCATCCCATGGCTATGGCGGTCGGTTTGGAGTGGAGAGAGACCGGATGGACAAGAGTGCCGTGGGCCACGAGTATGTTGCTGATGTGGAGAAACACTCATCTCAGACTGATGCCGCCAGAGGCTTTGGGGGCAAATATGGAGTTGAGAGA	101	112	250	261	11
2S43D:03934:07221	INITIAL_QUERY	CAGCATCCCCACCGTCGGCCTATGACCAGTCCTACCCAGTACCTGGGATCCATCCACCCTCAACATATGATATCATGGTGTAAAAAAAGAAACAACATGCGTGCAGACACACACACACACACACACACACACACAATCTCCTGTTGTATGTCCAAACTGTGGGAGTGACCACGTGGTTCTCCTAGCTGTGTCTGGGGAAGTCCCGAATAGAGAGCAGAACCAGGAAGAGCAGTCAGCAGATTCTGCCTGTGACCTCGCTGACCACGGTGGCTGTCCCAGCAGGCCTGATGGCATCCCACCTCAGACATCCATATCCCAA	590	601	69	80	11
2S43D:08368:12590	INITIAL_QUERY	CTCAGGGTGGCAGTGCAGCCTCTGGCTGAAGTGTAGCAGTCATCTATACCGGCCATCATCAGGAGCTTCTTGGGCACAGGAGCAGAGACAATGCCAGTGCCTCTGGGGGCAGGGATGAGACGCACCAGCACAGAGCACAGCGGCCTGCCTCAGTGGGTAAGAGCACCCGACTGCTCTTCCGAAGGTCTGGAGTTCAAATCCCAGCAACCACATGGTGGCTCACAACCATCCGTAACGAGATCTGGCGCCCTCTTCTGGAGTGTCTGAAGACAGCTACAGTGTACTTACATAATAATAAAGGTGGTTCTTTTTCCTTGATTCCTTTTCATATCTTGAGCCAGACTTATAATGTGTTTTGGAATCTGTTTAGAGGTGCCTCTAGTTTTGGTGTG	141	151	302	312	10
2S43D:09459:05648	INITIAL_QUERY	GGGCCAACTCCTCCTTCTAAAAATTCTTGTTTCTCTTTTTCTTTGAGTGGATCGGTATTATAGACTCGGAATCCATTTTCCATTCCACATGCAAAACACCCGTGGTCCTGGTTGAAGA	599	609	72	62	-10
2G5Z3:00138:12066	INITIAL_QUERY	CTCAAAGATGTCCAAAATGCTAAGTGTGGAAATGAGGATTGTGAAAACGTGTTAAATAATCTAGAAAGAATGCTCACAGATAAAAAACATCAGTGTGTCTAATGACTCATGTGCTCCAGCTACAACTATAGATTTATATGTACCACCAGGGACTGACAAGTTTTCGCTACATGACTGCACACCAAAAGAAAAGACTGATGATCGGACTTCTAGCTGTTCTCAGGTTCTGTTTCCTTTACCTATGCTCTTCCTGTTTGTGTTTGATTTGATTTTGCTGGTTGTCGACTTGGAACTTGTTAGTGTTGGCTTTCTTTGGGATCCTTAGGGTTGTGTAGATGGGCAGTGAGCCCCAGTGCATAGAGGAGTTCAGCTTGTTTGTCCCTCCGTTTCCCTTGAGCAGCCTCCTGTACAAGCAGAGAGATGCTAAAGCCTGATTGCATGTGTCAGATCCCAGAACAGCTCCTGGTCACCACTGGGACCTGGTCTCAGAGACAGAGACAGGGTCGGGCAGCTGGTGGAAGGCAGAGAGCTTGCCACGCAGTTGGGTGGTCTGACCTAATTCCAAAATGGCCATTTTCTCTTCTGATCTTGTAATACCTAAAATTCTGAGGTCCTTGGGATTCTTTTGTTTATAACAGGATCTTGCTGTGTAGTCCTAGCTGGCCTCAAACTCACAATACTCTTCCTGGGTCAATCTCCCAAGTGCTGGGATTACAGAGGAAATACTAAAACGAATGAAAGAGAAGCTACCATTGTCCAGCAGGTCAATTTCTTCGAAGAAGGAGAAACCAAGATCTACTACATAGTATGTATCGTGAAGCACGATGTCAAGGGATGAGTTAGGATAAAACAATT	601	611	568	558	-10
2S43D:07549:01955	INITIAL_QUERY	CCCTGCATGCTGATGCCATTCACCGGGGAGGTGGCCAGATCATCCCCACAGCACGCCGCTGCCTGTATGCCAGTGTGCTGACCGCACAGCCCCGCCTCATGGAGCCTATCTATCGTGGTGGAGATCCGAGTGTCCGTGAGCAAGTGGTGGGTGGCATCTACGGTGTCCTGAACAGGGAAGCGTGGCCGATG	471	481	35	25	-10
2G5Z3:06781:03905	INITIAL_QUERY	GTCAACATGCAATGCAACATTTTAGCGGAAAGATAAGCTGAAGTACACATTCGACCATGTTCATGGGATAAAATCTCCTGATGATTCTCTCAGTCTTACT	401	411	47	57	10
2S43D:03261:12667	INITIAL_QUERY	GGCGGCCATTTTCCACCATGATATTCGGCAAGCAGGCATCGCCATGGGTCACGACGAGATCATCGCCGTCGGGCATGCGCGCCTTGAGCCTGGCGAACAGTTCAGCGAAAGGATAAGCGTCTGCAGGGGTAGAGCTGAGGTCGGGGCCCGGCGGCAGGCGCCCGGCCACTCCCGGGCACCATGCCGTGTCCACCAGCAGCTGGCGGAGGAACTACAGATCTTCGGCCTGGAGAGTATGCAGCCGTGTCCCAGACCCTCCTACCTTATCTCTCTGTGGGCCAGTATGCTTGCAGACTTATAAGTCAGTATGGGGTGCTGCGTGCAGCCAGGTGTGTGGAGGGCAAGGAGGGAGGCCATCTGGGTATATGGGAATC	370	380	234	224	-10
2S43D:09509:05657	INITIAL_QUERY	AAATTGACTGTGTCCCGGGCAAGAAAGATACAGCGCTTCTTGTCTCAGCCATTCCAAGTTGCTAGGTCTCACGGGTCACATGGGGGAAAGCTGGTGCCCTTGAAGGAGACCATTAAAGGATTCCAGCAGATTTTAGCAGGTGAATATGACCATCTCCCAGAACAAGCCTTCTACATGATGGGACCCCGAAGCAGTGGTGGCTATGAACCCAGAGGCCGTGGAGGTGGCCGAGGAGGCAGAGGCGGCATGGGCGGAAGTGACCGCGGTGGCTTCAATAAATTTGGTGGTCCTCGGGATCAAGGATCTCGTCATGATTCTGAACAGGATAATTCAGACAACAATACCATCTTCGCGCAAGAGCCGCCTTCTGTTCCACTGCCGACTGTGACGCCGTAAATGGCTTTTCATCGCAGCCATGGTATGGAAATGCTTGGCACAGGCCCCACAACTGAAGTCTCCTGTCTGATGGGTCTGAAAGAGAAACCCAGCCCAGCTGTGGTCAGAAGCACTGATCCTGAAACAGCAAAAGAAACCAAAGCAGTCTCCGAAATGTCTGCTGAAATTGGGGCGATGATCTCAGTCTCCTCTGCAGAGTATGGCTCTGATGCAAGGAGTCTGTAACAGACTACACCACACCGTCAGGGTACCTGGCTAGGGTTGGTGACAGATTGCAGAGCCTGTGGGGGAGCGTTAGCAGACGGAGGAATCCAGTACATTGCTATTTCTTTCTGCGTGCATAAAATTGTATAGCATATTTAGAAACTGGATTTGTAATTAAGCAGGTTCAAAATGAATCTTCAGAGCATCATGATGCTTGATCACATGTCTCGATCCCAGTAGACGGTCTTGGGCTCGGCCATACA	547	559	566	578	12
2S43D:04675:13121	INITIAL_QUERY	CCCACGCATTCTTCAAACTATACTCTTTATATGCTCTGGGCTCAATCATCATAGCCTCGGCAGACGAATCAAAGACCATCCGAAAATAAAGGAAACCAATCGAACCAAAGTCCAGTCAATAAAGGGTTAAGCGCACACAAGCGTGGCCAACTAGCAGGTCCGGGGGTTCAGCAGCAGGCACCGTATGCAAATATGCAGAGGGGTGGGCTTCACGCCTCCCCCGCCGAGTGCTCCCACAGACGAGGAGTTGGTGCGCAAGGAGAGGAGGTTTAAGTCCAATACTCCATCGTGGGCCGCCCTAGGCACCAGGGTGTGATGGTGGGAATGGGTCAGAAGGACTCCTATGTGGGTGACGAGGCCCCAGAGCAAGAGAGGGTATCCTGACCCTGAACGTACCCCCATTGAACATGGCATTGTTAACCAACTGGGACGACATGGAGAAGATCTGGCA	8	18	398	408	10
2S43D:04675:13121	INITIAL_QUERY	CCCACGCATTCTTCAAACTATACTCTTTATATGCTCTGGGCTCAATCATCATAGCCTCGGCAGACGAATCAAAGACCATCCGAAAATAAAGGAAACCAATCGAACCAAAGTCCAGTCAATAAAGGGTTAAGCGCACACAAGCGTGGCCAACTAGCAGGTCCGGGGGTTCAGCAGCAGGCACCGTATGCAAATATGCAGAGGGGTGGGCTTCACGCCTCCCCCGCCGAGTGCTCCCACAGACGAGGAGTTGGTGCGCAAGGAGAGGAGGTTTAAGTCCAATACTCCATCGTGGGCCGCCCTAGGCACCAGGGTGTGATGGTGGGAATGGGTCAGAAGGACTCCTATGTGGGTGACGAGGCCCCAGAGCAAGAGAGGGTATCCTGACCCTGAACGTACCCCCATTGAACATGGCATTGTTAACCAACTGGGACGACATGGAGAAGATCTGGCA	231	241	251	241	-10
2S43D:09331:03253	INITIAL_QUERY	CAACACAGCTCGCTATGTGGATCAAGGTGGAAACAAGCGCCCAGGCGCGTTTGCTATTTACCTGGACCTTTGGCACTTAGACATCTTTGAGTTCCTTGACTTGAAGAAGAACACAGGCAAGGAAGAACAGCGAGCACGCGATCTCTTCTTTGCACTTGGATCCCACTCTCTTCTATGAAGCGAGTGGAGACATAAACCAGGACTGGTCAATTGGATGTCCCAATGAGTGTCCTGGTCTGGACGAGTCTGGGACCAGCAAATGAGGCCAGCCTTGTTTTTTAGCCCCTTGACTCACTTTTGGAGATTTGGCTGGGGTAGGAAAGCCTTTAGGAACGAGGTGACTAGGTTAGGGAATGCATTAGTGTTTGGGGGGGGGAAGGAGAACGGCGCCTGGGGGCAGAGCCTACCCCCAAAGAAAAGGGTGTCTAAAAATGTTCACGGTTCCTTCATTCCGATAACGAACGAGACTCTGGCATGCTAACTAGTTACGCGACCCCCGAGCGGTCGGCGTCCCCCAACTTCTTAGAGGGACAAGTGGCGTTCAGCCACCCGAGATTGAGCAATAACAGGTCTGTGATGCCCTTAGATGTCCGGGGCTGCACGCGCGCTACA	431	441	128	138	10
2G5Z3:09249:01972	INITIAL_QUERY	AATTAGTCTAGAAAACATAGGAGACAGCTTGCTATGCTTGTTGAAGGATCTCAGTGACAAATGAAAGATGAGAACAGAAACCTTGAAGGAAAAAGTATACGTTGAAAAGGAGACCTCAGCCTGTTGGGGGGCCAATTCCTGCCCTTCCATGCCCCTGCAGGCGGGCAGCACCACCAGCTGTCTTTGGTCCTCAGTTACAGGGGGCATACTTCCAACAGCTTTACGGCATGAAGAAGGGGCTATTCCCATGAACCCGGA	254	264	50	40	-10
2G5Z3:09089:07433	INITIAL_QUERY	TGGAGATAAGTTGCTTCCCCAAAGAGTCTTGGAGCAGCACAAACTCAACAAGGACCAGTGGGAAGAGAGGATCCAGGTGTGGCATGAGGAGCACCGGGGCATGCTCAGGGAGGATGCTGTCCTGGAATATCTCAAGATTGCTCAAGACCTGGAAATGTATGGTGTGAAACTATTTCAGCATCAAGAACAAAGGTCGAATGGGCAGGTAGCCGGATCAAGCGTATGCAGCCGCCGCATTGCATCAGCCATGATGGATACTTTCTCGGCAGGAGCAAGGTGAA	321	331	270	260	-10
2S43D:02071:12589	INITIAL_QUERY	CGGACCCTGCAGCCGCCGCGATGTGATGCCTAAGAAGAATCGGATTGCCATCTACGAACTCCTTTTTAAGGAGGGCGTGATGGTCGCCAAAAAGGATGTCCACATGCCTAAGCACCCGGAGCTGGCAGACAAAAATGTGCCA	366	376	9	-1	-10
2G5Z3:03463:02781	INITIAL_QUERY	CGCAAATATGCTTTTAAGGCAGCCCACCCAAACATGCGGACCTATTTATTTCTGCACCGATACAGGAAAGGAGATGGAGCTGTGGATGAAGGCCATGTTAGATGCTGCTCTGGTGCAGACAGAACCTGTGAAAAGAGTGGACAAGATTACAACTGACAGCCGCCGCATTGCATCAGCCATGATGGATACTTTCTCGGCAGGAGCAAGGTGAGATGACAGGAGATCCTGCCCCGGCACTTCGCCCAATAGCAGCCAGTCCCTA	118	128	152	142	-10
2S43D:01573:00891	INITIAL_QUERY	CCGGGGGAGGCCAGCGGGAGCCGGAGCACCAGCAGCAGCCAGTGTCGGTAAAGAGCAGCCAGAGCCACAGTCGCGATGGCCGTGGCGGTGGGGAGACCGAGTAATGAAGAGCTGCGAAACTTATCACTTTCTGGCA	275	285	33	23	-10
2G5Z3:05114:10005	INITIAL_QUERY	CTGCTCTCCAGCTTCCTGCTCATTGGCGTGCTCTTCATCATCAGCATCAGCCTGCTGTTCGGCGTGGTCAAGAACCGGGAGAAGTACCTGATACCCTTCCTGTCCCTTCAAATCATGGACTTCCTGCTCTGCCTGCTACTGGTCTGTTTTCTGTGCACTGTAGCCTTAGTGTCACCTTTCTTCTTGTGTCTCCTTATGGTACACTCCAGCGGTTGCCTTTTTATCATTCTACTGAAGTTGGGAAATTCAAACCCAGAATTAGACAGATGAAGGAAGACATGTATGTAGGGAGCGTCCATGCCAGCCATTTGGGTGTTCTATGAAGGTGGCATAGGGCAGTGTTTGTATGACCAGGGGTTCCCAGGTTCGCTGCCTTCTGTACAAGTTCACTACTGCCTTCTGAGTTCTCAAACTGATTATCTGCCTTAAAAAAGTCAGCGTGAGAGCATGCACCAGAAAAACTCGCAAGCAGGA	138	148	69	59	-10
2S43D:10371:08822	INITIAL_QUERY	GGCTGGCTCTCTGCAAACTTCTTAGCATCAAACTGAGCCATCTTCTCACACAGCTTCACCTCCCCCAAGATAGCCCTGAACTGGGGCTGGTTAATGCAGGTAAGGACACCGGTTGGTATTGGGGAAGGCCTGGCGAAAAGGCTGGGAGAGTGGGAGAGAAGTGACAGTGTGTTGAGCATTCACTTTCATTGGGAGAGGTTTCAAAACTGGAGTTCAGGTGCTCGTCCGTCTGGAGCCTGGGAAC	517	527	127	117	-10
2G5Z3:10210:05023	INITIAL_QUERY	CAACACCAGGACCTTAGGACAAATGGGACTGATGTCATCTTGAGCTTTTATTTTTGACCGTGATTTACTTTGGAGTGGTGGCATTGGTTTTTTTAAGGAAAAAAACATGTCATGTGGGTTGTCTAAAATAAAGTGCGAAGGAAAAATAAGAATTAGCCCTGAGACTGCCAAGGCACCACGACGGGTAGTAGGGTCT	218	228	175	185	10
2G5Z3:02241:14011	INITIAL_QUERY	CTCCACTTCGGCCTTCAAAGTTCTCGTTTGAATATTTGCTACTACCACCAAGATCTGCACCTGCGGCGGCTCCACCCGGGCCCGCGCCCTAGGCTTCAAGGCTCACCGCAGCGGCCA	365	375	61	71	10
2S43D:02268:08634	INITIAL_QUERY	GCCGCATCTCACTTAACTCTCTCTCATAATTGAATGGTGAGTCCTCCCCAGGGAGGGAGAAGGAAGCCACCTACTCTTGCTCTCACAGGTCAAAACCGAAGCATCATCTGGTTCTCTGCCGGCTGCCAGGTACCCTAGTGCCAAGCACGTCTGGTGCCTGATGCTCCGGGGTGCTAGACTGACA	487	497	156	146	-10
2G5Z3:03309:04529	INITIAL_QUERY	CACATACTCCAACGGTTTCCTGGTCCCTTGTTTCCAGGTCCCCAACTCCACTTCTTCCTCTGGCTGGCCAAGGACCTTCAGAGACACCAGCGTCTCATAGTTGCTTTCCATAACATTTCTGTAGAGCTCCTTCTGCCAGTCCTCCAGGTTCTCCCACTCCTGCTCCGAGAAACAGACTCCATCATTCATCAAACTCCGGCAACGCGCAAATCGGAAAGTGGCTCCTGACTCACGGGCCACAGCGGGTGGTGGATGGTGCCTTCAAGGAATCAATTTCGGACTACAGAGGGAAGTACGTGGTCCTCTTTTTACTAACCCGAACTGGACTTCACTTTTGTTTGCCCCACGGAGATCATCGCTTTTAGCGACCATGCTGAGGACTTCCGAAAGCTAGGCTGCGA	32	42	144	154	10
2G5Z3:03309:04529	INITIAL_QUERY	CACATACTCCAACGGTTTCCTGGTCCCTTGTTTCCAGGTCCCCAACTCCACTTCTTCCTCTGGCTGGCCAAGGACCTTCAGAGACACCAGCGTCTCATAGTTGCTTTCCATAACATTTCTGTAGAGCTCCTTCTGCCAGTCCTCCAGGTTCTCCCACTCCTGCTCCGAGAAACAGACTCCATCATTCATCAAACTCCGGCAACGCGCAAATCGGAAAGTGGCTCCTGACTCACGGGCCACAGCGGGTGGTGGATGGTGCCTTCAAGGAATCAATTTCGGACTACAGAGGGAAGTACGTGGTCCTCTTTTTACTAACCCGAACTGGACTTCACTTTTGTTTGCCCCACGGAGATCATCGCTTTTAGCGACCATGCTGAGGACTTCCGAAAGCTAGGCTGCGA	548	558	349	339	-10
2G5Z3:01184:07158	INITIAL_QUERY	TACCAGGCTCCTCCTTTGCAGCAGGCTCTCTGCAGTATAAGTCAGCCTCTCTAATTCTCAGAGTTCTGGAGAGAGAGTTCTGGAAGGAAACCGACCTTTCTATATTTGATCTCATTGGGCACACGAGCCAAAACACCAGCAACCACGTTGAAGTCAACTTCTTAGAAAAATTTACTACAGAAAGATACTTTCGTCCGAACACCAGATGCTCCATTACCTGGTTCCTGTCCTGGTCCCTGCGGGGAGTGGCTCCAGGCCATTACAGAGTTTTCTGAGCCGACACCCCCTATGTAACTCTGTTTATTTTACATAGCACGGCTTTATTCAGAGCGGGAGCAGAAGAACAACCTGCGCAAGGAGTTGTCGCACTACATGAGCATCAACGATTCCTTCTATACCAGCCACCTCGCAGGTCTCCTTAGATGGCCTCAAGTTCAGTGATGATACTGTCACCGCAGAGCCCAACAATGACGCCGAAGCCCTGGTCAATGGCTTGAGCACAGTGGCTTGGTCAATCATCAATTTTTAAAGAAAGAAAATGCTGAGGAGATCCAATTGGGTAATCCTTTGGTCAGCGACAGGTCCAAGCGCGTGGAGTTGACCTGAAGTCTCAATTCTCGAAGGATCTGTTCAAATTCAGCCGTCCAAGTCTCGCTCCTGGAAGATGGTGATGGGCTTCCCGTTGATGACAAGCTTCCCATTCTCGGCCTTGACTGTGCCGTTGAATTTGCCGTGAGTGGAGTCATACTGGAACATGTAGACCATGTAGTTGAGGTCAATGAAGGGTCGTTGATGGCAACAATCTCCACTTTGCCACTGCAAATGA	231	241	349	339	-10
2S43D:09080:02946	INITIAL_QUERY	GCAAGATGGCGGGTGAAAAAGGCGCCTGACAACAAAGGAGAAAGAAACCTGCGGCTGTAAACTTAATTTGCCTCCCTACCTCACACAAGAAGCTCGAGATCTGCTTAAAAAAGCTCGCTGAAAAGAAATCGCTGCTTCTCGTCTTGGAGCTGGCCCTGGGGATGCGTGGAGAAGTCCGAAGCTCATCCTTTTTTCAGACGAGAAGGGACTCGGGATAGCGTTTAGCACTTTGAACGTAGGAATTGCGATAATTATAGTGGCTGATGTAAAGTAAGCTCGTGTGTCTACATCTATCCTACTGTGAATATGTGGTGGGCTCATACAATAAAGCCTAGAAAAGCCAATAGACATTAATTGCTCATACTATTCCTATATAGCCGAAAGGTTCTTTTTTTTCCGGAGTAGTAAGTAAACTTACTTATGTGTGGGGCTGTGAGCTTGGCACAGCCTGAGGTACAATAAGCCCAGCCTGTGGTTTCAGAGTAGCCAGAGCTTCTCGAGCAGCAGTGACCTCTTTGGTGAGCCGGGCAATGGACTCGGCAGGCAGCATCGTGTTGGTACAGAGCATGGGGACAGCTCCTGGTCGGGTTGTCTGCAGTTGCTGGCGAAGAGTGAAGCTGTTGCAGCCATGAGATCCCACTGCACATAGGACTTATTCTTCTTACATGACAAAAAATTGCTCCCCTATCAATTTTAATTCAAATTTACCCGCTACTCAACTCTACTATCATTTTAATACTAGCAATTACTTCTATTTCATAGGGCATGAGGAGG	141	151	383	393	10
2G5Z3:04191:08126	INITIAL_QUERY	GACCTTGAGAAGCTGAAGATCAGAAAGAGATAGGAACTGAGTGAGGTCACACAGTAGATGCATAGCACAGCTGGGCTCTGGCCTCAGTGCACCAGACCACAGCCCTGCTTTTTCATTTGGGATATTGTGTTCCACCTACGAGGACCTGGACTGACGCAGGGCATGTGGAGAGAGACTACTGCAGGAGCCTCCAGTGACACCATTCCCTGAAGCAGGCTTCAAAACCACCAAGAAATCCAAGATGGAGGGCTACAGGCAAAGGACAAGTGGATCTGGCGACGTGTGCTGACCCCAGAGATCATGCTCCCATCCTGCATGCAGACGTCAGAGCGCCTGCTGCCTACCTGCCCTCTGGGGAGGCTGGTTGACCTTTAACCCTGACTCCTGAAGACTAGAAACAGTAAGGCGGCGGGCGTCACCAGACGGAGAAGCCACAGGCACCACGAAGGGGCTATCAGGTATGTGCTCCTCGTTGAACTTGACTGA	392	402	340	350	10
2G5Z3:04191:08126	INITIAL_QUERY	GACCTTGAGAAGCTGAAGATCAGAAAGAGATAGGAACTGAGTGAGGTCACACAGTAGATGCATAGCACAGCTGGGCTCTGGCCTCAGTGCACCAGACCACAGCCCTGCTTTTTCATTTGGGATATTGTGTTCCACCTACGAGGACCTGGACTGACGCAGGGCATGTGGAGAGAGACTACTGCAGGAGCCTCCAGTGACACCATTCCCTGAAGCAGGCTTCAAAACCACCAAGAAATCCAAGATGGAGGGCTACAGGCAAAGGACAAGTGGATCTGGCGACGTGTGCTGACCCCAGAGATCATGCTCCCATCCTGCATGCAGACGTCAGAGCGCCTGCTGCCTACCTGCCCTCTGGGGAGGCTGGTTGACCTTTAACCCTGACTCCTGAAGACTAGAAACAGTAAGGCGGCGGGCGTCACCAGACGGAGAAGCCACAGGCACCACGAAGGGGCTATCAGGTATGTGCTCCTCGTTGAACTTGACTGA	239	249	63	53	-10
2S43D:07327:05255	INITIAL_QUERY	CAGTCATGTAACTACAAGCAGCTTCGGAAAGGAGCCAATGAAGCCACCAAAACCCTCAACAGAGGCATCTCTGAGTTCATTGTGATGGCAGCAGACGCTGAGCCCTTGGAGATCATCCTGCACCTCCCTCTGCTGTGCGAAGACAAGAATGTCCCCTACGTATTTGTGCGCTCCAAGCAGGCTTTA	469	479	110	100	-10
2G5Z3:01932:02026	INITIAL_QUERY	CCCTCCCCATCCCCATGCTGCCAACTTCTAACCAGCAATAGTGACTCTGTCGCTTGTCTGTTTAGTTCTGTGTGTAAATGAAATGTGGAAATTGACCTACCTGCCCACTGGGACATCAGCCTGTCAAGTGTCCATGATGCTGGGCCCTGAGGGAGGTGAAGGCTATGTGGTCAAACTCCGTGGCTACCTGGTCCTGCTCAATTGAGACGCTGAGTTCGAGGCCAGCCTGGTCTACAAAGTGAGTTCCAGGACAGCCAGGGCTACACAGAGAAACCCTGTCTCGAAAAACA	392	403	96	107	11
2S43D:08057:04696	INITIAL_QUERY	AAAACTTAACAGTAGGAAAGGAGGAAAATGGCAGTTCAAAATTTGATGAAGTTTTTCCAACAAACGGACTAACTCTTCAGTACAAAATGGGGGTGAGACCACATTTATGGCTAAATTGTGCCCATGATGAACAGACTGCCGCTATGTTTTCACACTGACAGAAGGCGTATTGAAAATAATTTTGGTAATACTAAATA	600	610	22	32	10
2S43D:01108:05457	INITIAL_QUERY	TCTGCGTGCACACTCTTGACCACAGCTCCCAGGAAAGTTTGTCTCTAGACAAAAGTCGTGACCCAATTTTACTCTGGTAAGGGCAGAAACGGTTCACATTCCATTATTTGTAAAGTTACCTGCTGTTTGCTTTCATTATTTTACACAATTTGGCCTCCACCCATGACTACCATCAGCAATAGAAGGCCCTACACCAGTTTCAGCACTACTACACTCAAGTACAAATAGTAGTTGCAGGAATTTTCCTACTGGTCCGATTCCACAGCTAGGGTCATCCCTTAACCTCTCTTATCCCAAGCCTCCAGCTACTTACCAGAGATGCCTGCCATGATCCGCCCATTCTCAACTCCCAGTCTCTTACCCACTTCTCTCCTCCTCG	559	570	54	65	11
2G5Z3:05098:06989	INITIAL_QUERY	GTCTGTGTGAGTTCCGGGGGTGCTCTCCGCAGCAGCCGGGCGAAGTGACTCTGAGGCTGGGGTAGCCTGTGCTTTCCAGAGAGGCAGGGAAACGGGGACCCCGTCTAGGTATTCTCAGTCTCTCAGAAATGAGGAGTTCATCAAAGCAGAGAACAGCGGAAGAAACTGGTCTTCTTAGACC	288	298	37	47	10
2S43D:08111:13077	INITIAL_QUERY	TGGGAACCTAGCTGATGATAGGGGGTTCCATCTCCTAACTTGTCCATTTTGTTGCATATTCTAAGGACCCAGACATAGGCTTGGTGGCCCGTCTCTTGTTTTTCCATGTGGTGGCGTGCGCAGGCTGCTGGTCGAGCCGAATGGTGACTGCGGTGGCTGTGCTCGCTGGCCGCTGGGCCTGATCGCTCGCTTGGTGCCCGCTCCGTCGGCCCCCTCAGACTGCTGCGTGAGTGTGGCTGACGTCGCTG	241	251	155	165	10
2S43D:08111:13077	INITIAL_QUERY	TGGGAACCTAGCTGATGATAGGGGGTTCCATCTCCTAACTTGTCCATTTTGTTGCATATTCTAAGGACCCAGACATAGGCTTGGTGGCCCGTCTCTTGTTTTTCCATGTGGTGGCGTGCGCAGGCTGCTGGTCGAGCCGAATGGTGACTGCGGTGGCTGTGCTCGCTGGCCGCTGGGCCTGATCGCTCGCTTGGTGCCCGCTCCGTCGGCCCCCTCAGACTGCTGCGTGAGTGTGGCTGACGTCGCTG	409	419	186	176	-10
2G5Z3:09771:02647	INITIAL_QUERY	CATTCTCCAATCCCACCGCCCTGAGAATCCTGCATGCCAAATCCATTTGCCATGACTATCCTGGCAGACCTCAAAGGAGTGGCTGGCCAGAGCTTGCCTTTGCTGAGCCCAAGGTAGGACGGTGTCACTCAAAGACTTCCAGTGTGAAGATCATATTAGTAAAAAAGGCAGAGGAATACGGAATTCTGCTCAGACTTTATCACTCGATGGGGGATTCTTCAATAGA	210	221	78	89	11
2S43D:10217:04322	INITIAL_QUERY	GGGCTGCTGATCCGGGGGCTCATAGGAGTGAAGCCACCAACAGTTAAATTGGTCACATCCCGGGGCTTTGAGCCCCCAGCCAACACCAGGTGCCGTGCCTTACAGACAAACATGCCGCCGTTCTCCACCAGCTTCTTGCAGTCTGGACACATGTATCCGGTGTGGGGAGCTGACATGGCAGAAAGGACCTGATTGAAGAAGGGCCAGGGTATTTGCCAATGGTGAGAGCTGGACAGTGCCTATGTCTTCCTTCAATTCTGTACCGTATCCATCACCGCCTGAAGGAACAGCAGGAGGACTTTGCCGGCAAAGCAGCTCAGTACCAGAAGGAGGTGAAGCACCTACATCGGATGCTGCAGGAAAAGCAGGAGGTCCTGGATGAGGCGCTGCAGCAGAAAAGAAATATGGACTCCCTAGGAAAGAAGGGGTTGCTTTATGGATAAGCCTGTAGAATCGGCTGCTTCCTATGACTCCCTGGCTGCACAAGAAGAAATTGTCTGTCTTCCATATATGCTTCTAAGTATCCTACCTCTTTGAAGAAAAAGATAGGGATGGAGTGAGGTGACAGTGGGAAGGGACACAACTACATGGCCTTTCATGACCCTGA	90	101	451	462	11
2G5Z3:06291:05642	INITIAL_QUERY	GTCCCGCATGTCCATCTTATCAAATTCATCAATACAACAGACACCATTATCAGCCAGCATCAACGCTCCAGCCTCAATGACAAATCTGAGATTGGCCCATCTTGTGTTCCAGGAGGCCCCCCCTTCCACTCTGCGATGTACGTTAGTCCCCCACTTGACTTGCGGATCAAGTGAGTCTCA	81	91	33	43	10
2S43D:01876:11760	INITIAL_QUERY	TAAGTACCTGCCTTCACTCATTGCTGGAGCTGCCTTCCACTTGGCTCTCTACACAGTCACAGGACAGAGCTGGCCTGAGTCATTGGCACAACAGACTGGATATACCCTGGAGAGTCTTAAGCCTTGTCTTGTGGACCTTCACCAGACCTACACCTGGAACAGCCAGGACAGCAGACACTCATCAGCCTGAAGTCCTCTGAACTGGATGAAGATGAGGGTTTTGGTGACTGGTCCCAAAAGCCGGAGCCACGGCAGCAATTCTGGGGGAATGAGGGGACTGCAGAAGGGATCCAGTTCCTCACGCTTTGCTCTCTCTTCCTCCTCTCTTGGCTTTTTGTGCGTGCAACT	78	90	84	96	12
2G5Z3:00472:12662	INITIAL_QUERY	CGCAGCTTGGCGCGGCCCCGCACTCGCTCCTTAAAGGCTTCCAGTTCATACTTGAAGCCCTCCATGTACTGGTGGTCAGCGGTCTTGATCTTGGTGAAAAACTGCCGGAAGCAGGCTCGGGGGATAGCGCCAATCTTCCTTGAGACTCTGCGCCATGAGAGCGAAGTGGCGGAAGAAGAGAATGCGGCAGGCTGAAGCGCAAGAGAAGAAAGAGTGAGGCAGCTGGGTTTGGATCACATAGCAGTGAACAAATGGATAAAAGAACTTTAGAAATAGTTAAAGCAGGAGACCACTGTGATCTTAGAATATCAAGACAAATGCTGCCATTACTGTTAATATTTGGATGATAAATTCTTGTTGTAAAAGGGTGCGTGTGGGAGGTAGCGTGAGTGGTGGCCGTCGGGTTGCAGTATTTTGGTCAGATGTGTCCTACGAGGAGCACTGGGATTTTGCAATTTAGCTCAGCGCAAAGAAGAGCGCCAGGCTCACCTCACTAACCAGTATATGCAGAGGATGGCAAGTGTACGAGCTGTGCCCAACCCCGTGATCAACCCCTACCAGCCAGCACCA	519	530	477	488	11
2S43D:00605:04127	INITIAL_QUERY	CTCAAGGGAAACTATTTCTACCTACAACACAGACATGGGTCACATGTTAATGATCGTGACAGCTGGTCACTAACTTACTTTCTGAGCTATTTTATTGGCAAGAACAAAAGGTGTAAGCATCTGGGTAGTCTGAGTAGCGTCGTGGTACTTCCATGAAAGGCCCAGGGAAATGTTGAGGAAGAATGTTATGTTTACTCCTACGAATATGATAGGCGGAAGTGGCTTTTGCTCAGTGTGTCA	562	572	33	23	-10
2S43D:02767:03720	INITIAL_QUERY	TGGGCTGGAGCGAGCAGGGACTGGGCACACAGGGTTGACCGGAGTGAGCAGAGGTCCTAAAAATCTAATTCCCAACAACCACAGGAAGGCTCACAACCATCTGTACAGCTACAGTGCACTCACAT	73	84	18	29	11
2S43D:07166:01235	INITIAL_QUERY	GGCGAGTGTCCACAACTTCAGTCTTCATTTTTCTTGAGTTTCATGTTGTTTAGGAAATTGTATCTTATATCTTGGGTATCCTAAGGTTTGGCTAATATCCACCTCAGTATAGAGACAATAAGCCAAGAACAGAACATGTGCCTTCAGGACCTCTCAGACAACGAGAAGAAAGCGAAACACGAAGTGAGAGTTCTGATTTTGAGGATTGTTCCCAAAAGAAGGCGACAGAGGGGTTCTGAGACGGACACGGACAGTGAGGTTCATGAAAGTGCGAGA	413	423	169	179	10
2G5Z3:09110:01109	INITIAL_QUERY	GTGGGCTCAGCTTCTTCTCGATACACATCCTGCACACGATGTTGGCAAAGAACCGGTGTGCATGATCGTC	139	149	46	36	-10
2G5Z3:10369:03276	INITIAL_QUERY	CTTGGATAACTGTGGTAATTCTAGAGCTAATACATGCCGACGGGCGCTGACCCCTTCCCGGGGGGGATGGGCGTGCATTTATCAGATTCAAAACCAACCCGGTGAACGCTCCCCTCCCGGGCGCCGGCCGGGGGTCCGGGGCGCGCCTGGTACCCCCATGTTGTTCCCTTTTAGTGACAAAGGGATGTCCAGGGTAGAGAGCCCGGGGAAGTGGTAGCTGCTGGAAGGTAGGCAGGACTGCCTAGAGCCCTACATAGCTGTAGATTAATCTCTGCCGAGACACAATAAATTGTTGTACAATCTCCAAAAAAAAAAAAAAGAAAAAAAAAAGGGGGAACGCCGACCAGTTCCTCGAGTCACCAAGCAGTACCTGCCTCCATGATGGCGCGCCTCTGCCTGATCAGCACCTTCCTGGAGGATGGCATCCGCATGTGGTTTCCCAGTGGAGTGAGCAGCGTGAGTGGTGCGGTTACCCCTGGTCATTGGCAATAATTTCCACCTTCCATGCTGGAAGACACCCACACAGGAGTAGGTGGTGCCGAGATCAATGCCAACTGCAGGTCCCTTAGACATGGTTGCTTGTGTGTAGGCCCAGCTGCGCTGACGACGAGACA	123	133	595	585	-10
2G5Z3:01013:13021	INITIAL_QUERY	TTTGGCTATCACCCTGCGCAAGGGCAACCTAGGAGCAGACAGAATCTGCCAGGCCATCGAGACGTATGACCTACAGACTCTCAGCTTGGATTTCTTGGAGCTGTTGACCCGCTTCCTGCCACTGCCATGGTTTTCTGCTCAATGCTACTAATAACCCTCCAAGAAAGATCGCCTGGCACCAACTACAGTTCTTGTAGGCCACAGATGAGGAGATTTCGATTCTCGTTAGATAGTGTTCATAGCTCTGTCACCGCCTTCAA	232	242	13	3	-10
2S43D:07108:04397	INITIAL_QUERY	GGTTCATTCAGGTGGAGGTCCCAGGGCGGGCTGGTGCAGAGCAGAGGGGGGAGCCCCGTTGGAAGGTACAGAGCCTCCTAGTCGTGCTTGAGAGTGAGGCGCTCAAAGAGATACTCGCCCCAGAGACCCCTGGGGCGCGCCA	174	184	2	-8	-10
2G5Z3:07466:13385	INITIAL_QUERY	CAGGCATTGGTGATCTCTGCTACAGAAAGCTGCTCATGGTAGGCTTTCTCAGCAGTAGATGACAGGGGCGATAAGGTGGCCAGAGGGAAGGTGGATGCGAGGGTAGGGTACCAGGTTGGTCTGGAATTCTGTCAGATCAACATTCAGGGCCCCATCAATCTGAGGAAGCAGTGATGGAAGACAACAATCTCGGGGGTCTTCCGTTCACTGTTGCGCTTCAGGCCGCTGGCGTCGCCCCGGCCTCCCGCTTCCCGGCGCCTCCGCCTCGGCTCCACAGGTACATAGCCCCAGCCACCCAGCAACCAGGGCGGGATCAGTCAACCTTCACGAGGACCTGGGCCTCGGAGCTTTGCTGCCATACAATGGAATGCTTGCATGACTGTTGAA	172	182	140	130	-10
2S43D:08885:11577	INITIAL_QUERY	GAAGATTCCAGTCTTTCCTTGGAAGATGAGGCCAAGCACCCCCCTTCCCAATATGTAATGTGTGCTGCAACTTCGCCAGCCGTTAAGCTGCACGACGAGACACTTACTTACTTGAACC	555	565	90	80	-10
2S43D:03455:11606	INITIAL_QUERY	GCCAGAGATCTGATCTACGTACACCTGCGTCATGCTGAGACCCTCAAGCCTCACTAAAAGGGTCCCTGCCTAGTTCTGTTTACTAATCTGCCAGGCAGATTCTGGAGCCAAGCACACCAGAGACAGGTTGGTGGGAGGCACCCAGCTGGTGCTGTTGCCAGGAGAGACCACAGCCCACTCCATCCATGCAGGGACAGGGGACTTGCAGCACGATGGTCTCCGGGTGGTAACATCATTGCTTTTTGGGTGCCTGAAGACAAAGATATTCCAGCCAGGGTGACCCTGATGCAGCTCCCCACCAGACAGGAGATCCGAGTGAGGAATTTGTTCAATGTGGTTGATTGCAAGCTGCACTGGCAGAAAAATGGAGA	9	19	324	314	-10
2S43D:05375:08248	INITIAL_QUERY	TTTGACTCCCCTGGGCTCAACCCGTGTTCAATGATGACTGGCCTGAGCAACTAGGACTGCCTTCCTCCCAGCCACCCATCGCCTGTGCACGCACCTCAGTACACACATGTCTGGTGACCACTGGCAGTTGGGAAAGGCTTCAGGGCTGCCCCACAGTGATGATTTGTCATCTTTGCCCAACAGCAGGACCACAGGGGAAGTGAAGCAAGGGGTGCTCTGATTAGGGGGTCCCTAGAGGCAGCTGATGAGGGACTCGGGGTGCAAGGCTTCAATGGCCTCTCGCTGGGCAGGGGAGCACTCACCAAGTAGGTTAGAGCTCCTGTCTCCCACGCTGACAGTCACTTTGGAGGCTTGTGGCTTCCTGGATACTCTGATCTACAAATGTGGTGGAATCGACAAAGCGAACCATCGAAAAGTTTGAGAAGGAGGCTGCTGAGATGGGAAAGGCTCCTTCAAGTACGCCTGGGTCTTAGACAAACTGAAAGCTGAGCGTGAGCGTGGACTCAAGACTGATGGAGGAAAGGCTATTTTTACTTCTGCTGTCATAGTTTGGCTCATTCATTTTCACTTGCTTATGAAGGGACAGTTATCCTCCCAGCCTGCCACTTTCTTTAGTGTTAAGCACATAACGAACACAAGAGCTATCCTCTACAAGCGGCTCCAAAGTCCTCCTGACCATTAACCACGTTCACCCAGGCCCTGGACAGAGACAGCTACTCAGCTGCTTAAGCTTGCCCACAAGTACAGGCCAGAAGACAAAGCAAGAGAAGCTATGAGCGGCCCAGCACGACATGCAGCAAGCCTCAGAGGGTAAGCACAACTCAGAGAGCGAGCGGGCGCAGCCCAGCAGCGAAGATGACAGGGACGAGCGCAGAGTCCCGGGCGGAGATCCAGAACGCGGAGACTACATCGAGATTTCCAGCCCAGAACAGCATCAGTCGGACACCACCCCGGAGAAGT	6	16	267	257	-10
2G5Z3:10120:05233	INITIAL_QUERY	GCTGCAAGGAAGCAAAAAAGGCTAAGCAGGCATCAAAGAAGACAGCAATGGCTGCTGCCAAGGCCCCCACAAAGGCAGCACCTAAACAAAAGATTGTGAAGCCTGTGAAGGTCTCTGCCCCAGAGTTGGTGGGAAACGCATCGACGGTTTCATAGTTATGTGGTGGCTTATTAGACCCTTGATCACTGGAATTGCCTCTGGGCCAATTTGCCTCTTAATGATAGGACACATAAATCCAGGTTAATGTGCCACATGAACAGAGTTGAAGTTAAAGTGAAGATCCCTGAAGAGCTGAAACCCTGGCTTGTGGATGACTGGGACTTGATCACCAGACAGAAGCAGCTTTTTATCTTCCTGCCACCATGTTTCAGCCTGGCATTCCTTGTACCGGAACTGACAGATGAGAACTTCTGCGGTGGCCACACGGGCGGCGCCCACTGCACAGTGGCCTCCAGGGTTGCTTCCTCAGAAATATCCACTTGAGAGAAGATCTGGGGTGTGTCTGGCTTTCATTTGGGTCTGCCAGGTTCCACAGAGAGAG	574	584	24	14	-10
2G5Z3:09141:03299	INITIAL_QUERY	CGAAAGCGAAGAACGGAAGCCTTCCCTTGCCCCTCCCAAAGCCGAAGCCAGGGGACGGTTGGACCGGCAGATTGGAGAGATTTGAATTGGAGCCAGGGAGCCCTCGAGACCTACCAGGGAGGGGCTGGTCCCTGAGACTGCCAGCACACAGGGATAGGATCGTAGGAACAACCAAGGTCAGAGCATGACTTACACTCCAGGGTGTAGCTGGTGGCAATGACAGACTCTGCCCAGGCAAGCAGAAGATTTAACCTGGGGATCTATGCATCCTGTCAAGAGGGTGGGTCCCCATCCCCGTGTGTGGAAAGAGACAGTAGTGGCTTGCTGCCGAGGCTCAGGCCGAGGTCTGGACAGCTCTCACTCTCCTCAAGCCAGGACTCATCGACCAGCAGATTCACCCATCAAAGGATGACAATCAACATTCCAATGCATCTCAGTCCCTGTGTGACATCATCCGCCCTAGCCGCGAGCAGGATGATCCCAAGGCCAGGACAGCCCTGGAGCCAGACCAGCTGTTGGCCACCTTGGAGAAGCAGGAGAACCATCCTGCAGGCATGGGTTATACAACCACACCAGAGTCAGACACTGTAGAACAGATTGGAAGAGATAGATACTGTGCACCTTTGCTTTCCTTACAAGGAACGATTTTATAATTCTAAGAGCCTTCCGCAACATCCTGTATTACTCTGCTTAATGTAAGCAAGCTAACATTTTGAAACTGGCTCCTGTGGCTGTGGCCGTTTCTGCGATCTGGACGGTAGAGTGCTTTCGGAGACTGGGGGTGGGGTCCGAGGGGCGGGGACGCAGTCTACATCTCCTGGGCTTCCGGCTCCTTGCTCGATCCCGTTGCCATGGCGCCGCCGAGCGCCGGACGTTGCTTGTGGCCGCCTGTCCCGAGGACAAGAAGATGCCACCCAGCGCATAGCTAAGAGAGGTCACCCCCAGAAGATGCCATCC	469	479	470	480	10
2G5Z3:06408:04334	INITIAL_QUERY	TGCATCTGTTCAGACCAATAAATGTACTCTACAGCAGAAATACCAAAGTTTTAACTCCGGCCGGCTCCTCATCAATTCTGTCTTCCACATGGGTGCTGAGCGTCTGCAGCAGATGCTCTTCTCGGACTCTCCGTTCCTGCAAGGCTTCCTGCAGCAGCGCAAGTTCACAGATGTGACCATTGAGCCCTTGGAGCAGTGACAGCAAGTGCCACCAGCGCAGAGTCCTGACCTACACCATCCCA	484	494	111	101	-10
2G5Z3:02991:02760	INITIAL_QUERY	TGGAGATATACAAAACCTGAAGAAATGGAGTCTGTGCTCAGGTCACACAGGGGGGCTTCAGAGGATCCTTATGAAAGATGAAGTTAGCTGATCTTTCACACCAGATAGATGTGTAATTTTTGATTTGGCTAGTGCAGTGTCTTCCAAGTCTTTCATTCATTGCTGTCGGACGTCTGCTCCTGCTGTCCTCATTCCTGACGGAAGTGTGTGATGCCCACATCTGTCTGCTTGGACCACCGTGAGGTCAGACTGGGGGGATAAGGCACATGGCCCATCGAGAGCATGCCAAGCCCACCCAGCTCCTTAGGGGTGTAGAATACAACAGGCGAGCAGCCACCTCAACGTCGGTATCGCCGAAACTTCAATTACCGACGCAGACGCCCAGAGAACCCTAAACCACAAGATGGCAAAGAGACAAAAGCAGCCGATCCACCAGCTGAGAATTCGTCCGCTCCCGAGGCTGAGAGGCGGGGCCATGATAAAAGGTGCCGGCTACCATACTACCATCATCCGTGCCAGCTTTCTTTTCAGAATCAAAATGCAGAACAAATGGAAAATTTTATGGTATTTAACCTTCACAAGTTTGAGCCTCCACATATAATGCAACCAAGTTTACATTTTTTGAACACCCTCTGCTGCTACAAACTCTTCCAAGAAGATGAAGTTCCAGGGAGAACCCAAGGAAACCTACCTATGAACGGTTTACCGAAGTTCTCCCAGGAGCTGCTGTCCAATTGGGGAGCTAAATCACCTGCCGCTGAAGGAGCGCATGGTGGAGATTGGCAGCCGCTGGCACGCACTCCAGAGCAGCTTGCTCCTGAGCCACACTCGAGGGCCATGGGCATGGGCACTATGGGGATTTCTACCCCTGGCCTGCCAGGTGTCCAGGGACTCTTGCTAGCTCACCAAGGTTTT	325	335	810	820	10
2G5Z3:02991:02760	INITIAL_QUERY	TGGAGATATACAAAACCTGAAGAAATGGAGTCTGTGCTCAGGTCACACAGGGGGGCTTCAGAGGATCCTTATGAAAGATGAAGTTAGCTGATCTTTCACACCAGATAGATGTGTAATTTTTGATTTGGCTAGTGCAGTGTCTTCCAAGTCTTTCATTCATTGCTGTCGGACGTCTGCTCCTGCTGTCCTCATTCCTGACGGAAGTGTGTGATGCCCACATCTGTCTGCTTGGACCACCGTGAGGTCAGACTGGGGGGATAAGGCACATGGCCCATCGAGAGCATGCCAAGCCCACCCAGCTCCTTAGGGGTGTAGAATACAACAGGCGAGCAGCCACCTCAACGTCGGTATCGCCGAAACTTCAATTACCGACGCAGACGCCCAGAGAACCCTAAACCACAAGATGGCAAAGAGACAAAAGCAGCCGATCCACCAGCTGAGAATTCGTCCGCTCCCGAGGCTGAGAGGCGGGGCCATGATAAAAGGTGCCGGCTACCATACTACCATCATCCGTGCCAGCTTTCTTTTCAGAATCAAAATGCAGAACAAATGGAAAATTTTATGGTATTTAACCTTCACAAGTTTGAGCCTCCACATATAATGCAACCAAGTTTACATTTTTTGAACACCCTCTGCTGCTACAAACTCTTCCAAGAAGATGAAGTTCCAGGGAGAACCCAAGGAAACCTACCTATGAACGGTTTACCGAAGTTCTCCCAGGAGCTGCTGTCCAATTGGGGAGCTAAATCACCTGCCGCTGAAGGAGCGCATGGTGGAGATTGGCAGCCGCTGGCACGCACTCCAGAGCAGCTTGCTCCTGAGCCACACTCGAGGGCCATGGGCATGGGCACTATGGGGATTTCTACCCCTGGCCTGCCAGGTGTCCAGGGACTCTTGCTAGCTCACCAAGGTTTT	91	101	419	409	-10
2S43D:08843:09718	INITIAL_QUERY	TTTTTATTTGCTTATTCCTTCATGTCGGACGAGGCTTATATTATGGATCATATACATTTATAGAAACCTGAAACATTGGAGTACTTCTACTGTTCGCAGTCATAGCCACAGCATTTAATAGGCTACGTCCTTCCATGAGGACAAATATCATTCTGAGGTGCCACAGATTATT	67	77	97	87	-10
2S43D:00087:09269	INITIAL_QUERY	TGGATGTTCTTCTCCTTCAGGCTGGCCACAGAAAGCCTGAGAAAGTGCCTTCTGCCTTGGTCTCCAATCACAACTTATTGAGCTGAGACCACACGCTGTCTCCCAAGGCAGAGAGCAGTTTCCATCCTG	212	222	19	29	10
2S43D:01917:02032	INITIAL_QUERY	GTGAAAGTTTGTCTCTTCTTGTGTGAACATGGTGCGGACCAAAGCAAACTACGTTCCAGGAGCCTACAGAAAAGCGGTGGCTTCTCAAGGCTCAGCCCCTTCCCTCCCTCCCCTCCCCCAGATACAGCCACCCAAGTCCCCTCCACCACAGCACAGTGGTGCCCAGAGATCTCGGTCGTCTGCCGGGACGAAGGATGTCTTCTTGCTTGGTCGATGGGACAGTTTGGGAAACTCTAATAGTTTCCCCACCATAAATTTGTTGCTATTCGTAACTGTTGACTGTAGTATCTGATATGCTACCCACAAAGATCATGATGATCTCCAAGCTGAGTTATTTATTGCTGGTCTAAATACTTATTGCACCGAATA	609	619	67	57	-10
2S43D:02613:09546	INITIAL_QUERY	GCCGTATTCATTGTCATACCAGGAAATGAGCTTGACAAAGTTGTCATTGAGAGCAATGCCAGCCCCGGCATCGAAGGTGGAAGAGTGGGAGTTGCTGTTGAAGTCGCAGGAGACAACCTGGTCCTCAGTGTAGCCCAAGATGCCCTCAGTGGGCCCTCAGATGCCTGCTTAAGTAGCAGCAGCAGCAGCAGCAGCAGTAGCAGAGCAGCAGTCATCTGGACCACCTGATGTCATCACTCCATAATATCATCCGGTCTGCCCTTCTACCAGATCAGCGATTCGGGCTTCTCCTCCTACCTTTCCCTGAACCAGGGCTGCGGGGGTAGAGGTGGAGGTGGGGTAGAGACTGCGGGGAATTGGCACTACAGGAATAGGAATACAGTCAGTGGAGCAGGGTGGCAAGTGGTGGTGGTGGTGCGGTGTGGTGCCGGTGGAGACAAAGGA	574	585	159	170	11
2G5Z3:05951:02362	INITIAL_QUERY	AGAAAAACCAGAACAACCCGACGCAGAGATAGATCTGGATCATCTCAGTCAACATCTCGAAGAAGACAGAGGAGCCGGTCTAGATCACGAGTTACTCGGAGACGGAGGGGTGGCTCTGGTTACCATTCAAGATCACCTACCAGACAGGAGAGTCTCGAACCTCCTCTAGACGCAGAAGAGCCGGTCTTGTCGATCAGGATGATCTGGACGAAGAGCATCAGGGCTCGCGCCAGCCGAACTGTTCGCCATGCAGTCACTGTAATTCGATAGGGGACCCCTCCTTTGAACTCCCCTGGTAACAATGTGCTGAGGTTTCCAGGGGGGAGACGGGTCCAGTTTGAGCTTGTCCAGGCTA	453	498	178	223	45
2S43D:01759:12661	INITIAL_QUERY	AAAATGGCCGCTTTTCTGGATTCATCGACTGTGGCCGGCTGGGTGTGGCGGACCGCTATCAGGACATAGCGTTGGCTACCCGTGATATTGCTGAAGAGCTTGGCGGCGAATGGGCTGACCGCTTCCTCGTGCTTTACGGTATCGCCGCTCCCGATTCGCAGCGCAGAGACCCACGTGTGGAGAGATGGTGTGAGTCACAGTCACTAGCATGTGGATAATCTGACCATACAGTGGATGCACAGCCACGTTCACTGTCTCATTTGTTTCAGGTATTTCAATTTTTAGAGGTAGGGTCTCACTGTGTAGCTCAGGTTGGTCATAAACTTTCTGTCTTCTTTGTATACTAGGTGCTGGACGCGTGGGTTAATTCCCACATGAGGAACTGGCAAGAACTCACAGCAGCTTTGACATTGAGTAACAATGTCACGGGCTTCTTTTCTTGTCAAGGAGAAACGACTGCGTAATGTTTCAGCCGTCACATGAAAATTATTATGAAAATTCTGCAGCCTCTACCGGGGACGCAAGATGAGGGTGAATGTGGACCCCGAAGACCTCATCCCCAAACTCCCTCGCCAAGAGACCTCAGCTTTCCCTGTGTGCCAGGCCCTCGT	602	648	0	46	46
2S43D:00469:12031	INITIAL_QUERY	CCCAAGTGCTTTGGCCATATTTCTCACAGCAATAAAAGCAAAACTACGGAGGGACCCAAGCAAGGCAGGCCCTGAGAGGAGGCATCAGCTCGGAGTAGATGGGCCTGGATGGAAGCTGGACCCCAGCATTCACATCACGAGCCAAGCGTCCACAGACACCTCTGACTCCAGTTCCCAGGAATCACCTCTTCTTCTAGGCCTCTGATGCACAAAAGCTGCCGTAGGAAGTTATACTGGCACATGATGGTGAGGAAGAATCCCACAGAAGCCCTCGACTGTCATGGCCACCAGTCCCACGTGTGACAATGTCCACTCGAACGGGACTCATCTTGTCAACTGCCAATCTTGGCGTAGTTATTCGTTGTATGTGACTCATTGTAGGACCATCTCCATGAGCCA	446	456	106	116	10
2S43D:01563:11671	INITIAL_QUERY	CAGATGGTGAGGATGTGGCCTAGAGTGCCCAGTCACTCATGGAGTTAAGCCAAACACAAGGCAAAGAGGATCTTGGCCATACTAGGTGGTCAACTCGGTGCTCTGGGGGCTACAGAGCCCAATGATGCCTTGGATACATTGGCAATAATGGGAAATTCATCCGAGTTCCAGAAGGCAGTCAAGTTAGTGATCAACACTGTTTCATTTGACAAAGATTCCACAGTCCAGG	72	82	25	15	-10
2S43D:08729:02424	INITIAL_QUERY	TGCTAAGGCAGGAGTGCTGCAGATCTGCTTAAGAGTTCACAGGTACACAGCCCCCCAACCCTCCCTTCTGGGAACTCCTCCCCTGGGGGATATATGATACTAATTAAAAGTTTAAGGCCGTTTAGATGGAGGAATACAATAATACCTAGAAGGATATGGGAGGAGGCAGAGAATAGGCACGAAGGCCCATTTTCCATGTCCTGTCTAAGGAACTGAAACTTAGAAAACGAAAGTACTGTCAGAGTCTAA	599	609	186	176	-10
2S43D:07282:03495	INITIAL_QUERY	TACTACTCGGCTTTCCCGTCAAGATTGCCTGAGGAAGGTGCACCATGGAGAGGAGGAGGTGGAGACCGCGAGGATGGTGATGCATCTTTGGGCCCATAAGGACACTGCACCCAAGACCACACGGCATCAGAAAGGGCAGGGCAGGGCTGGAGTGAGCCGCTGTGTCCAGGCAGGGCACCGGGACCGGCAATTTTTTTATCCAAAAGAAAACCTCATCTAGATAGGAGTCTGCCAGACTCCCACCTACGTTTCTTGGTACTGACATGGAATCGCCTCCACGGTTCGGGCAGCAGTGGGGGCTGCTGTGGCCTTGGGCCGGGGCCGGTTGTAGCTATTGTATCTGTCCGTGGCTGTGGCCCCATCTGTGCTGGCCTTCCCTGTCTCTGGCTGCTCCAAGCAAATATTCAAACGAGAACTTTGAAGGCCGAAGTGGAGAAGGGTTCCATGTGAACAGCAGTTGAACATGGGTCAGTCGGTCCTGAGAGATGGGCGAGTGCCGTTCCGAAGGGACGGGCGATGGCCTCCGTTGCCCTCGGCCCACCCCGATACCCACACATCTTCAGGATCTAAGAATGGCGTCTGGAAGGACAGGGGCGAACTCCACTCGCCCCATGGATATCCGTTCTCCACCTGGCAGCGGCCAGACACCTGGTAGCAGGTGCCAGGTTCCAGGTTCTGCATCTCAACAGGAGTCAGCCCATCTGTCTTCAGCTGGGGCTCA	100	110	121	111	-10
2S43D:08672:07345	INITIAL_QUERY	GCTTTCTGCGTGTGGGGAAGAATTTTCCTTAAGAAAGTTTTGTCTCTGGATATCCTTGCTGTTTTTGTTTGATTCTCTGTATGAAACTGAGAACTGTTGAGAGGTAGCTGTTGGTGGGCTAATATTTATTAATACTAGAGTATGCTCCTCCGATAGGTGTATTAATAAGTGTCCTGCAGTAATGTTAGCTGTAAGCCGGACTGCTAATGTCATTGGTTGTAATAAAGTGTAGGAGACGATGGGAGGGTGGCTAGGGCACAAAATTTTTGCCCTACCCCCAAAGGGAGAAGAGGTTCAAAATGTCAGTGATTAAAAAATGTCAAACACTACCCGCTCTCACGTTTAACCCGACCAATCACCGACTGCCCATAGAGAAGCTGAAAAAAGACTGCCAAGGCACACAAGGGGATAGG	183	193	170	160	-10
2G5Z3:00615:05221	INITIAL_QUERY	GGAGCAATGGGCACGAGCGATTCAGAAGACACAAGGTGATAGAGGGGGGAGGAGCTGGGCTCTGTGCTTGACTCCACCTCTGGTTCCAGATCCTACAGCATGGGATCATCGCCAATTGGGCTCTAGTTTCAACCTTGTCGAGGACCTGGCGTGCAGAGTTCTCCGACAACATTCTTCAAACCAGCGTGCAATGTAATCCCACATATAATAAGGTTCGAAGGAATTAAAAAGCAGATTTGCAGTTTTAATCAGTTCGGCTGTTTTCTTA	506	516	250	240	-10
2G5Z3:10274:09142	INITIAL_QUERY	CACTTACCATGACTTTGTGAAGCCACACATGTAGTCTTATAGTACAAAATAAATTTGTAAAAAAAAAAAAACAAAAAAAAGGGAAAAAGGGGGCTGTTACTGGCCTTTGGGGAAGCTCTGAGGTGAGGGGTAGTCAACCTTCCCACTGCAGAGGTGTGGCCACAGGGTGAGAGAGAAGAGGAGAGCACCTGGCTTTGGTCACAAAACTCAGGGCCTGGCGCTAAGCCAGGACAGACAGACGGAAGAGAAGCCTCAAAACCACCCTCCAGGAAGCAGCACTACCTGACCAGTTCCACTGTGGACCTCGGCTTCTCGCTGTCTGCTCGCGCCCTCGTCCTACAGCACAGGCCTCCCGGCTCCGGCTCCGGCTCCAGTGTTGGTTGGGTGGCAGGCCTGGTGTGGTCTCCAAAGCGACTGGAACAATGCAGAAAGTACAGTGGCCCATTCGATGCTCCGTTTGCGTGATATATATCGGATTAGTCACCCGTAATTTACGTCTTCGACAAATGTGTGTTACTGATGAAAAGGCTGTTATTGTAATCTGATGTGTAGTGTATGGCTAAGAAAAGACCTGTAATGATTTGGACTATTAGGCAGATGCAATTCACTCATATGCTGTAATTCTGACACATGTGCATCTGTTGCTCTAAGTCTAGACACAGAATGGCTTCCCAAATGTGGACGTGTCTTGCACTAGTTAGAAGGCAATTTTATAAAAAATAGCAGGAGCAAAACTGGACATTTTGCTCGA	398	408	439	449	10
2G5Z3:10274:09142	INITIAL_QUERY	CACTTACCATGACTTTGTGAAGCCACACATGTAGTCTTATAGTACAAAATAAATTTGTAAAAAAAAAAAAACAAAAAAAAGGGAAAAAGGGGGCTGTTACTGGCCTTTGGGGAAGCTCTGAGGTGAGGGGTAGTCAACCTTCCCACTGCAGAGGTGTGGCCACAGGGTGAGAGAGAAGAGGAGAGCACCTGGCTTTGGTCACAAAACTCAGGGCCTGGCGCTAAGCCAGGACAGACAGACGGAAGAGAAGCCTCAAAACCACCCTCCAGGAAGCAGCACTACCTGACCAGTTCCACTGTGGACCTCGGCTTCTCGCTGTCTGCTCGCGCCCTCGTCCTACAGCACAGGCCTCCCGGCTCCGGCTCCGGCTCCAGTGTTGGTTGGGTGGCAGGCCTGGTGTGGTCTCCAAAGCGACTGGAACAATGCAGAAAGTACAGTGGCCCATTCGATGCTCCGTTTGCGTGATATATATCGGATTAGTCACCCGTAATTTACGTCTTCGACAAATGTGTGTTACTGATGAAAAGGCTGTTATTGTAATCTGATGTGTAGTGTATGGCTAAGAAAAGACCTGTAATGATTTGGACTATTAGGCAGATGCAATTCACTCATATGCTGTAATTCTGACACATGTGCATCTGTTGCTCTAAGTCTAGACACAGAATGGCTTCCCAAATGTGGACGTGTCTTGCACTAGTTAGAAGGCAATTTTATAAAAAATAGCAGGAGCAAAACTGGACATTTTGCTCGA	326	336	722	712	-10
2G5Z3:06881:10382	INITIAL_QUERY	GCCGAACTGTTCGCCAGGCTCAAGCGCGCATGCCCGACGGCGATATCTCGTCGTGACCCATGGCGATGCCTGCTTGCCGAATATCATGGTGGAAAATGGCCGCTA	554	614	44	104	60
2G5Z3:04038:04848	INITIAL_QUERY	GCCAGGCTCACCTCACTAACCAGTATATGCAGAGGATGGCAAGTGTACGAGCTGTGCCCAACCCCGTGATCAACCCTACCAGCCAGCAGACCAGGCCTGCAGGGGATGGAACCTTCCAGAAGTGGGCATCTGTGGTGGTGCCTCTTGGGAAGGAGCAGTATTACACATGCATGTGTACCATCAGGGCTGCCTGAGCCCTCACCCTGAGATGGGAGCCTCCTCCATCCACTGCTCCAACATGGCGACCTTGCTGTTTCTGGTTGCCTTGGAGCTGCAATAGTTCACTGGAGCTGTGGTGGCTTTTGTGATGAAGATGAGAAGGAGAGGGCAGGTTGACATAAGAGGCCTCTGTGAGTGGCTGATGGTCAGCCCTGGGATCGGTCACCACTAGAAGCCGTGGCTCCCTGAAGGCTGCTTGGATCTGGTTAGTGAAGGTCCCAGGTGTGAAGCGGCCAGCGATCGGAGTGGCTCCTGTGGCAGCAGCAAACTTCAGCACAGCTCGCTGGCCAGTGTCCTGGAGGAGATG	520	530	0	10	10
2G5Z3:00572:05263	INITIAL_QUERY	GGGTGGGGAAGAGCAAGGAGTCCACCCAGGGGAGGCAAGGGGGCATCCACACTTGGGGGGGAGTCACACTGGGGTGAGTAAGTGAGATGGGACAGGCAGTGTCTGAGTCCTGGAGTTCCAGAAATTTCTGAGACACCAATGCCGCCGGCGCCCGACCCCGGCCGGAGCCGGGAGGGAGCTCACCGGGTTGGTTTGATCTGTATAAATGCACGCATCCCCCCCGGGAAGGGGGTCCAGCGGGCCCGTCGGCATGTCATTAGCTCTAGTAATTACCACAGTTATCCAAGTAGGAGAGGAGCGAGCGACCAAAGGAACCATAACTGATTAATCGAGACCGGCCACTTGTAGCCTCTTGGATATTTTGGGCAATCAGAGATTTCGTTTGGAAGTCTATGTTTATCTCTTTGGGAGCTTCCTTCTCTATGAAGTCGGTATAGATTTTCCACCCCTGCCAAAGCTGAAGCAAAGGAAGAGTCGGAGGAATCAGATGAGGATATGGGATTCGGTCTCTTCGACTAATCCCGCCAAAGCAACCAAGTCAGCCTGCCA	597	607	437	427	-10
2G5Z3:04081:06272	INITIAL_QUERY	ACACAATGTCCGGAGCCCTTGACGTCCTGCAGATGAAGGAGGAGGATGTCCTCAAATTCCTTGCTGCGGGAACCCACTTAGGTGGCACCAACCTTGACTTTCAGATGGAGCAGTACATCTACAAAAGGAAAAGTCGACAGGTATCTACATCATAAACCATGAACGAGGATGAATTTCCTGTACCTGCTTGGAGAAGTACTAAACAGCTATATCTGGGATACACAGAGAAGTATAGAAGAAGAAAAGAGAAGCCTAAGCTGGAATGAGATCCAAGATCGTGAGCAGGAGAAGCAGGGAGGAGCTGACCCTGGAAGTGCTTTGGGCCCTGAACACCATTAGTGTGGAGACAGAACTTCAAAGGAGAAA	184	194	22	12	-10
2S43D:06918:06389	INITIAL_QUERY	GCAGTTACGATAACATTGTAAATTTGGTCATCTCCTAAAAGTGCACCTGGTTGACCTAATTCTGCTCGAATTAAAATACTTAGTGCAGTACCCACTATTCCAGCAAGAGAAGATTGACAAGCTGATGATCGAGATGGACGGCACAGAGAATAAATCTAAATTTGGTGCAAATGCCATCCTGGGAGTGTCCCTGGCTGTCTGCAAAGCTGGTCGCCGTGGAAAAGGGGGTGCCCCTTAGTGGTTCCTACCTTCTGTAGTGGTGTAATCCCAATCGGGGCGTTCAAGGGGAAAAGCAGCATTGACTTCATTAGGCAACTGAGTGGGGCGTCCATCATTGCCCCGGACTGCCTTTCTAGCCTCTAGGACGCACCCGCTGCTTTTCGGATATCCATGGGGCGAGTGGAGTTCGCCCCTGTCCTTCCAGACGCCATTCTTAGATCCTGAAGATGTGTGGGTATCGGGGACCGTCGTGTGAAACTTCATGGCAAACGGGCAAGCCCTGGCTTGTCCTGGAAGGACCCAAGACCATTGGTCGTCGTGGGGGATGTTTGCTCCAACCAACTGCTGTCGCCTTCACCGTTCCAGTTTTTAAATCCTGAGTCAAAAAGCGCCAAAACAAAAACAAAAAAACTAAAAAAATAAAAAAAAAAACTGATGTAAGTAAGCTCGTGTGTCTACATCTATCTACTCGTGAATATGTGGTGGACTCATAGCAAGTAAAGCCTAGAAAAGACCAATACGTAACAAGGGTCTGTTCCCCACACACCAGCACTCAAATCAAACAATATTGTGCTTGTATAACTTTCTATGGGGAAGTCTAAGAGACTTTACAGATAGTCCAGAAAAGTCTCAAGGCTGGGAGGAGCAATGAGGCCTTTCATCCCTTTTGTATTCTGAGTTCTCCTTCCTGTTTTCTTCTCACCTGATAAAACAATT	612	622	837	827	-10
2G5Z3:07310:10082	INITIAL_QUERY	GGCCATTCAATCGGATATCTCATGGCCTACAAGGAGTTTATTCAGTTCCTTTAAGAACTTAATGCAGATCAACCAATTGAGCTGACGTGACAGTGATAGGTTCTGGCCCTGGAGGATATGTTGCTGCCATCAATCTGCCAGTTAGGCTTAAGACAGTCTGCATTTGAGAAAAATGGAGACACTAAGAGCTCAACTGGACCCGTCTCCCCCCTGGAAACCTCAGCACATTGTTACCAGGGGAGTTCAAAGGAGGGGTCCCCTATCGAATTACAGTGACTGCAGTATATTCTGGAGGATTAGCTGCTGCACCCTCAGTTTGGGATTCAGAGACCACCTTTATGGTGTGCTACGATACCTTCCTGCTCTGCAGTACCAGCAGCCGACATCAGTTCTGCTTGAACCATATCCCCACAGAGCCTCTACCAACTGGTTCTGTGAGGGACATAGCCCTTTACCCTCCCTATCAGTGACTGCCGGGTTCAGCCAGCCCTCTGTCCTGAGGCCAACAGAGCCTCACATGCATGGCCCCAGCCACCCTCTCCCACCTGCACTGGGAATTCAGGGGCCTGCAGAAGGAAGAAATTGTTTTACTTACACATGGAGACAGTGTAGACAAAGTTGCTGATGGATTCAAGGTTGTAGCACGTTCTGGGACATCTGTAGCCCTTTTTGTCACCATGATCAAATTATACAATTCTCTTCATGATATATACACTCAGACCCAAACATCAATCGAATTCATTAAATATCTTACTACTATTCCTGATTTGACCATGCTTATCCTCAATCTCCCAGTAGTGTGTGTGGCAGTTGCTTGGTAGTAGAAACCTTAGTGGGGCCTGAGTCCCTGCCCGTTGGCCTCTGCCTCTTGTGGTTCCTGAGAAGGCAGTAGAACCTGGACAGTTGCCCACCCCTCTTGTTTTGATGGCAAGATTCCCAAGGGTAACTCATTTGATGCCAACACGCCACACCAACAATCCTGGTGCTCAGTATACATGACCACACTAAATCCAATGAACCCCCTTGTAGTTCATTTCCACTCTGTTACCCAGTCTGTCTCTGACAGGTCGTTTCCGCTTGAGGTGACCTTGCCCATTCTCGTCTTCCTTGACCCTTGGTTTTTGTCACCATGCATCTATTCATCTACGAATCTTTGTCTAATTCCTTGTGTACTCTTGAGATTCCTTCTTAGCAAGA	145	155	665	675	10
2G5Z3:01589:12860	INITIAL_QUERY	GTTCTTCTTGCGGTCTTGCCATTCCTGGACCCAAAAGCTCCATGCTTCCACATCTTATGCCTTCTTTTCACTCCCAAGACCACATGCTTCCATCCAGCACCGACCTCCTTCCTCGCCGACCACCCTCTCGTCGTCCTCCTCCTCCTTCCTTCCTTCCTTCCTACACAGGCCGACCCCATTGAGTTGGACAAGATGCTGATGTCCAAGGTCAAGGTGCCACACACCTTCCTATACATAGCTACACACGCCACCGCCTCCTCCACAACTTCCTTCTTCTCCTTCAAGTCCTTGGTGGTGATCTCGGAGCTGGTATCCACTGCCGCGTCTGACATGGTGGGGCACGCCGGTGGTCCGATGCCGCGAGTGAGGAATTAAAAGTCGAGAGCTTTTGTTATAATTTTCTTCATAGTAATACCAATAATAATTGGAGGCTTTGGAAACTGACTTGTCCCACTAATAATCGGAGCCCCAGATATAGCATTCCCACGAATAAATAATATAAGTTTTTGACAGCCACGCCTACTGCACACCTCTCAATGCAGCTTCAGGCTCCATGGCTGAGAATAGTATACCTCTGTACACTACCGCTTCCATGGAAATCCACTCTGGGCAGCCTGGCCAGTGCCATCCGGGAGGAGCTGACGGGCCATGGAGCACACCAACAGCACGAGAGTGACAGCAGTACCAGGCAGATCCCCTATGGGGCAGTGTTGGGGGTGCTGAGGCCCCCCCCCTCGGGAGAAGAGCAGCAGGTCATCCCTGGCGGGAAGGCACAGTAGTCATCCTGTTCTCCAGCCAGAGGCAGCAGAGGTGGGTGGGGAGATCCTCGGGCACCTGACCCATCCTCCTCCACCTCCTCTCCACACAGGGTCATAGGTGAAGTACACA	446	456	85	75	-10
2G5Z3:06049:03270	INITIAL_QUERY	GTCTGCTAAGAAGTTTGGGAAACTGCATATAACAAAAATGCACTGTGGGTATTTAGAAGATAAATTCAATATGTATGCTGCCTTTGCCTTGGGAAGACAGGGCAAGAGCTGATGGGACTGCTGTTTCCTGTAGCACCTACAGCAGCTGAAGTGGAGTTGACTCAAGCTCCTCAGACTGGAGATACACCTTCCACAGACAGCATCTGAGGCCGCCTTCAGTGTTGTGACTGCATGGTGTGAGGCAGTCCCTCTGCATCTCTTTGTTCTGACAGTGCTACCAAAGCTGGCCCCATTTGGAGCAACACACTTCAAGGGCTCAGGAGCCAAGCCCTCAGACACAGCATCGGAAGCTACTCGTCCAGCTACCTTGAATCGCTTTTCTGCTCTTCAACAAACATTACCCGCAGAGAACACTGCCTTCATGACCTTGAAACGATCAAAGTCTGTCATCTTGGCTTTCCTTTCTCTGGCATCAATTTTCTTGGCCCATCTTGTGGCTGCCCATTTCGTATTGATATCCGCCA	610	620	373	383	10
2G5Z3:06368:12812	INITIAL_QUERY	CACAGACATGGGATTCACACCTCCCTCATCACCTCCCACTCGGCCCCGCAACGACCGCAACGTCTTCTCTCGTCTCACCAGCAATCAGAGCCAGGGCTCAGCACTGGACAAGTCTGATGACAGCGACTCCAGGGGTGGGGAAATCTTCCTAGGCTTTTAGGAGATTTCACTCCTCTTTTCCTGTTCAATGGCTGCGAAGGGAGGGATGTGGTCATTGGAGCTACCTTACAGCCCCCC	7	17	182	172	-10
2S43D:06207:13207	INITIAL_QUERY	CTAATATCCACATTACTATGCTGGAAGGCATAGTATTATCCTTATTTATTATAACTTCAGTAACTTCCCTAAACTCCAACTCCATAAGCTCCATACCAATCCCCATCACCATCTTAGTTTCGCAGCCTGCGAAGCAACTGCAGGACTAGCCACTCCGACCCCGCCGCCGCGTTCGAGCTGAGCCCTTGCAACTTCGTCGTTCCGACCGCTCCAGCGCGCCACCGCGCCTCGCCCGCCGCCACCATG	182	193	135	146	11
2S43D:06199:12811	INITIAL_QUERY	CTCGGCTCGTCCTCGCCGGCCGGGGAGAGGCCCCGGCCGCACTTCGGGGACTCCCGCTGCTCAAGATGCAATGAGGTGACAGATTATGCTATTGCCAGGCGCATAGTAGACTTGCATTCAAGAATTGAAACGGATCTTCTTCTTTTTGTGGCTGTGGACGCCTTTCAGCACCGCCTTCTTAGCTTTCAAGCCTTCGCTTTGGCTCGGCTTTGGGAGGGCGGAGCTCCTTCTTCGCTTTCGGCGCCA	143	153	139	149	10
2S43D:07301:00624	INITIAL_QUERY	CAGTGGATGGAGCATTTTGAAACCTGGCCTGCCACCTCCCATTGTGGCCCATGCAGAGCGGCAGAGTGTCGCGCGGTCCTCGATGGTGGGCCTCAGCTGCCCAGCGCCAGTCGCACATAAGGACTACCTATGTGGGTGACGAGGCCCAGGAGCAAGAGAGGTACTCCTGACCCTGAAGTACCCCATTGAACATGGCATTGTTACCAACTGGGACGACATGGAGAAGATCTGGCA	8	18	182	192	10
2S43D:07301:00624	INITIAL_QUERY	CAGTGGATGGAGCATTTTGAAACCTGGCCTGCCACCTCCCATTGTGGCCCATGCAGAGCGGCAGAGTGTCGCGCGGTCCTCGATGGTGGGCCTCAGCTGCCCAGCGCCAGTCGCACATAAGGACTACCTATGTGGGTGACGAGGCCCAGGAGCAAGAGAGGTACTCCTGACCCTGAAGTACCCCATTGAACATGGCATTGTTACCAACTGGGACGACATGGAGAAGATCTGGCA	325	335	146	136	-10
2G5Z3:10444:11632	INITIAL_QUERY	TCATGGATGATATGATCAAGCACTCCCTGGATTTCCGAGAGAGCAGAGAGGCAGAGCCACACCCACTGTGGAATACCCCTGCAGAAGCCTCTCCAAGCCTCAAGAGATCCTGACTTTTGATTTCCACGCAGCCCATCCCA	53	63	85	75	-10
2G5Z3:06282:11239	INITIAL_QUERY	CCTTATAACTGACACACAGTGGAACTTGTGGGATTTTTATATATATGAAGGAGTTGTTCATGGCAGCTCGCTCTTTCATCTTGTCAATATCATCAACTGGGTGCTCAGGTAATTTGCGAAATTGATTCTTGTTTTTGTTCCCATGTTAAAGATAAGAGTAAATGCAGTATTCTCCACATAGAGATATAGACTTCTGAAATTCTAAGATTAGAATTACTTACAAGAAGAAGTGGGGAATGAAGAATGAAAAATTACTGGCCTCTTGTGAGAACATGAACTTTCACCTCGGAGCCACCCCTCGGGTTGCTTCCTCAGAAATATCCACTTGAGAGAAGATCTGGGGTGTGTCTGGCTTCATTTGGGTCTCCAGGTTCACAGAGACAGAGGACCACAGAGGCCGTCCCTTTTGTGTCCCCCAGATGAGGAGTTTGTCAGCCATGGTGAACATGGAACCAGGGTGGTGGATATGGTGTGGAGGAGGAGGCTATGATGGTTACAATGAAGGAGGAAATTTTGGTGGAGGTAACTATGGTGGTGGTGGAAACTATAATGACTTTGGAAATTATACGTGGACAGGAACAATCAAATTATGGACATGAAGGGGGCAGTTTGGTGGAAGAAGCTCAGGCAGTCCTCCAGTACAAGTACGAGGCTGGCGAGATCCGATGGGGAGCAGAAGGCCGCGATGATCTGTGCCACCAATGGGTCCAGTCAGGTGAGTGAGGGGCCCCGACCCGGACCCTAATCCTGCCGTCAAACCGGAACAA	548	558	682	692	10
2S43D:00100:08294	INITIAL_QUERY	AGAATAATGACATCAGGTGGTAGGGTGACGAGTCGGGGCAATTAGACCTTTTTATCTACCTGGAAGCTAGCTCTGGAGATGTCCTGCCACTTGGCAGGATCTTCAAGGGCCATCGCTAGCTCCCATAGAAGGCCTGATGCTGTTCTACTCTACAACACTGGGGATCCTGCCTCCACCCCTTGAAGGTTTACCCTTACAGATGTGCCTGGCCATGTGTGGATTCCTTCCAGAGGTCATCTTCTCCTCCCCCTGCTCGCACACCAGCTTACAGTGATGCTCACAGTAAATCGTTTTTCTCGTTATATTTACTTGGTTGTGGGTTCAGAGGATTGGGACTAAACTCAGTCTCCGA	302	312	92	102	10
2G5Z3:09638:01972	INITIAL_QUERY	ATTTTTCAAGTCGTCAAGTGAATGTTTCTCATTTTCCACGATTTTCAGTTTTCTTGCCATATTCCAAGTCCTACAGTGGACATTGCTAAATTTTCCACCTTTTTCAGTTTTCCTTGCCATATTTCACACAATACTCCATTGTGCAAAGGAGGAACACCTGTTCGCCCAAGGACCGTAAAAACTACCAGCCCCTGCAGTCCCCCGTTCATGAGCAGTTTCTTCAGCCAAACTTTGATGACAAGGAGGAGAACCTTGAAAACATAGAGCCACCTCAGG	597	607	89	79	-10
2G5Z3:06165:06897	INITIAL_QUERY	CGGGATGGATAATTTTATTCAAAACCTCAACCAGAGAAAACAGACACTAAATACCTTTTAATGAACTCAATCTCCTCGGGGAGATGAGAACAAAAGTCAGGATTCTATTAAAAATGTTCCTGATCTGAAGTTCAGAAACAGGATAAGACATTTGAACATGTCAGCACCCATCATGAACTAACTGTAATTCCCTTAGGTTCTTGGCATGACAGTATGCCAGATATTGCCTTTTCACTTCTAAGAAGGTATATACAGCTTGTCGATTCCTTCTCGAGGTGATGCTGGCAAGGGTCAGGGTACTGATCGGCTACTTTCAACAGAATCGCATGATGAAGTAACTAATATTCTTCAACAACCATTGGCCCTTGGATACCTCCAGTCCACGCTGTAGATTGTGTCCGGGTGCACATCCGGGCCCAGCGTCAGCACAGCTGCCCCATGTGCCCACGTCCCTACACCAGGATGCACATTGTCACAACCTGCGCTGAGAAGCACATTCT	124	134	478	468	-10
2G5Z3:01499:14388	INITIAL_QUERY	GCACTATTTAGAAAATTTGTCCAGTCCCTTATTTCAGAGAATAGAAACATGAGGTTTACGGAGATTGGGCCTCATAAGAAACTACTTGAGAG	270	280	20	10	-10
2S43D:06726:07753	INITIAL_QUERY	TCCCGCTTCAGTGACAACGTCGAGCACAGCTGCGCAAGGAACGCCCGTCGTGGCCAGCCACGATAGCCGCCGCTGCCTCGTCCTGCAGTTCATTCAGGGCACCGGACAGGGTCGGTCTTGAC	151	161	112	102	-10
2S43D:07136:08144	INITIAL_QUERY	GGGAGTGGGTCTTCCGTACGCCACATTTCCCACGCCGCGACGCGCGGCGGGGATTCGGCGCTGGGCTCTTCCCTGTTCACTCGCCGTTACTGAGGGAATCACGCCGCTCTGTACTGTCATCGTCATCTGCATGAGCATTGGTGCTAGAGGTGCTCTGAAGTGTAGGCAATCCTTCAGTGACTCCTTCATCTACTGAGCCTATAGAGGAAGATTCAAATCAGGTCTCGAAGATATTTCAGGTGTCTTCTTCAAACGAGTAA	256	266	171	161	-10
2S43D:10089:02828	INITIAL_QUERY	GTGATTCATAAAACGAATGTTGATAGAGACTGTTTCTCTTTAATCGACCTGTCTCTCCCACGAGCACTGCGGCCAACAGGGAACGCACCTTCATCTGAGGGAATGGGCTCCTAATGGTGGAAATTCAGGAATTAAGGAAGTTCAGTTGAGAATGTATTTTGGAAGAGAGCAGAGTTGCAAATATCCATCTATTATGCTTTTGTATT	595	605	113	123	10
2S43D:02412:03531	INITIAL_QUERY	CGAAAAGGGAGAGTCATCTGGCAAGAATGTCACTTTGCCAGCTGTGTTCAAAGCTCCCATTCGACCAGATATTGTGAACTTGCGTT	399	411	55	67	12
2G5Z3:06912:06236	INITIAL_QUERY	CCGAGCAAGATGCCCAAAGGGAAGAAGGCCAAGGGGGAAGAAGGTGGCCCCGGCCCCCCGCCCGTCGTCAAGAAGCAGGAGGCCAAA	220	230	58	48	-10
2S43D:06082:07379	INITIAL_QUERY	GAAATGCTTTTATACAGACTCTCTGCTAACTGACAAATATACCTAAAATCATTTCCATTGAACATAAAAGGAGTATGCCAAATTTTATATAAATTTTCAGGTTCTGTAAGCTTTCTGGGTTTAGGCTACCTTACTCTGTTTATCCCTGGGCTCTTTAAGTGGAATTCTCACCTGTCTCCGTCTCTTCCTGTTATATAAAATGAAATGATGATAATTAGGATGACAAGTAACAGTGAAACTAACCCTCCAACGATGGAAGGATAAATGTTTATTGGTTCCACCATCAGTTATGATCAGCCACATTCGTCATCTTCATTCACCTTTCACTCCTCATCTCCTTCT	8	18	54	64	10
2S43D:07520:00459	INITIAL_QUERY	AATGCGGCCCGACCGTGCCTCCCCTGCCCATGAAAGTGCCGGTCACAGTGTGTCTGTGACCAAGGAGCGCAGTCATGTGCTGGTGGGCCTGGAAGATGGCAAATTGATCGTGTGGGCGCTGGGCAGCCTTCTGAGGTACGCAGCAGCCAGTTCGCGCGGAGGCTGCTGGCGCTCCGTCGCGGCGATCTCCCAGGTGTCCTCTGGGAGACTAATACAATCCTGGCGAGC	275	285	141	131	-10
2G5Z3:08797:04340	INITIAL_QUERY	CGCCGCAGTGACCACCAAGTCAGAAAGGCTCATTTCTTGGCTAACTTGCTACAGACAGCCTGCAGCGTGTGTTAGTGTGCACTGGTATCTGGACCCTCGATTCTTTCCATCAATGAGCAACAGCGGCATTTTCCATGTAAATGTATGTGGTAAAAGGCCTAGGAGATTTGTTGATCCAATAAATATGATTAGGGAAACAATTATTAGGGTTCATGTTCGTCCTTTTGGTGTGTGGATTAGCATTATTTGTTTGATAATAAGTTTAAACTAGTCAGTGTTGGAAAGAATGGAGACGGTTGTTGATTAGGCGTTTTGAGAAGAGCATCGTCTTTTATTTCATCCCCCTTTGGTCAACCAAAGGTGACAAACCAGTGAACCATAAAAACATTTTAGTTTGACTAGGAGGTGTGGCACACGGCCTTTACTCTCCTGTCTGCGACTCCATCTGATTAACCCAAGACTTGTAAAATATCCACAGGGGTTCGGTTTTGATGTTGAGAGACTTGTCATCCATAATTTCCCTTCACGACAGGGGCCAAGGATCTGCCGGAGGCATTCTGGCCCCGGGCACCACGTGAACTTACAACCCTACTCCTGTTTTTTTTTTTTTTTTTACATACACATAACTCACATGCAACTGCAAACTGTACTCATAACTAAAAGCATAAAATCTTTTAAAAGAGGCAACCAGTAAACAAAACCCACTAAATTCATTCTCATATGAGAAGGTTAATTATTTTTCTAATA	406	416	9	19	10
2S43D:01515:06346	INITIAL_QUERY	GGCATGGGAGAACCTGGAGAAGGCAGGAGAGGTGGAAATGATGTGAGCACAGTCCTCTTGTATAGAATTCTCAGAAAAGCAAAAGAAACAAAAGACACCAGTGATGGCATGAAGCCCTCAGGAAGCAGAGCAGAGTGAGTGTAAATGGTGCAA	32	42	6	-4	-10
2G5Z3:10438:04877	INITIAL_QUERY	CCCATGTCTGTCTGCTGCCTGCTCTGACTCTGTTGGCTTTTTCCCTCGCCTCTCCCTTTTTCTTTCTTCCGAGCCTTTTGTTCTTTTTCTACATGCTATCAAGTGATTAAGATAGGGCTGGAAAATTCTAGAGGAAATTCAGGACAATCTATCAGAAGTAAAGCGGGGGGGCATTGTGGGATATGTTGAGACCCCCACGAGGCAGTTCTTTATCACAACAGTTCCGACTCCTCATCTCGGAACGGGAAACATGCTGGATATTTGGTTCAGGTACATAAAAGGACTTAGGTGTGGCAAGGACGCTTAAAATGTAGAAGACTTGGTCTTCGGGGTTTCGTTGACTTCCGTCTTAGAGGTAACATTCTTCTTTGCTTGGGACGAAGCCTCTTCTGGCTGCTTATCAATGTAGATGAAAGTGTACTGCTCTACTCTTTCAGCCTCCACCTCACCACCAAGCCACCTTCACCCTTAGGTTTGGCCCAGCCA	407	417	447	457	10
2G5Z3:00972:12523	INITIAL_QUERY	CTATGCTCTGACCCTGCAGGCGCCTTGGGAAGCGCCCAAAGGACTCCCTTTCATTTTGGTGCATCACTCCATGGCTCCCAGCACCGCAGCCTGGCGGGCCAGTTCTCCACAACGATTAAAGTCCTACGTGATCTGAGTTCAGACCGGAGCAATCCAGGTCGGTTTCTATCTATTATCGATTCTCCTAGTCACGAAACGGAAGCAAGAGAAATAGAGCCACCCAAGCGGACACGAGACTAAGACAAAAAAGAAACCAGAAGAATCAGATGGCCTCTCTAAGGCCGGCCGATTGAGACCCTCTGCACGACAGTCACTGTTCTTCCTAGTCCCCCGAGAGGCCCCACTTCAAGCTCCCCTCTGACTCTCTCGAGTTCACCGAAGTATCCAGAGTTTTCACTGAGAGAATCC	44	54	218	208	-10
2G5Z3:04512:07555	INITIAL_QUERY	TTTCAATACCTCGACAGATTTCCACTAAGAATCAGTTCTTTCCAGTTGAGGCTGGTGGTTCACACATATAATCCTAACAGGGAAGAGGCCAAAGGCAGGGACAGTTCAAGCTCAAGGCCACTCAAGAAAACTGTGCTATCTTGGCCTCTAACATATTAGTACAAACTGTCCTAATCTGAGAGAGAGAAAGTCCTTTTGATTTCCATTTGACTGCTTTCTATGAGCCACGCCTCATCTTCCCTGTGCACATGTTTACCTGACACAGCAGTGCTGCGTGTTGTACATACTTGGAAACAACAAACTAGAAAATACTGTACTTCTGTACCAATCTTTCTTCAGTTGTGGTCTTCAACAGTTAGCTGGATTCCCGCTGGACGGCGTCCAACTCATCCATGCCTCGCTGAGCACGCAGCACTACGCTGTCTGCTCAGAGCATCAGGTCAGAGGCTATCCAACTCTGCTCTGGTTTCGAGATGGCAAGAAGGTGGATCAGTACAAGGGAAAGCGGGACTTGGAGTCACTGAGAGACTATGTGCAGTCCCAGCTGAGCAGGGTTCCA	486	497	429	440	11
2G5Z3:01921:08131	INITIAL_QUERY	GAGGACCTGTATCCGCCCACTGCAGGACCCGACCCTGCCCTCACAGCTGAGGAATGGCTGGGTGGTCGGGATGCTGGCCCCCTCCTCATTTCCCTCAAGGATGGCTACGTGCCCCCAAAGAGCAGGGAGCTGGAGGGTCAACAGGGGCCTGGACAGCGCTCGCAGAAGAGCTAA	183	193	18	28	10
2G5Z3:01943:07874	INITIAL_QUERY	GAAAACACACCCATTATTTAAAATTATTACCACTCATCATTGACCTACCTGCCCATCCAACATTCATCATGATGAAACTTTGGGTCCCTTCTAGGAGTCTGCCTAATAGTCCAAATCATTACAGGTCTTTTCTTAGCCATACACTACACATCAGATACAATAACAGCCTTTTCATCAGA	392	404	44	56	12
2S43D:02280:07351	INITIAL_QUERY	CAGAAGATTAGCCTGGCAGTGCTTCAAGGCGTTTGGGTGGTGCGTTGAATGAATGGTGGTTTTTAGAAGACAAGAGCTGTTTCTTACCCGTCCGGTTAGCTTCAGCCTCCTACAGGAGAGGCCATGCCGAGACCCCGCAAGAGGCAGACTGGGACATATCAATTGCAGCAAGACAGTGAGAACTGTACCTGTGGCGAGTGTGTGGAGCTCGTGCTTGTGCTCGGAGCGTATGCCGTCCAAGGGTCCGCTGCAGTCCGTGCAGGTCTCGGACGCAAAGAAAACAGCCCACGGGCTGTGGGACCCCAACTGCAAAACGGGGGAAAATTGGGGCTTCCATCAAGGTGGAACGGACCGTCCCCTGGAGATGATCGAGCCGCGACACGCTGCAGTACAAGTTACTGGAGACTCATACAATAAAGCCTAGAAAGCCAATAGACATTATTGCTCATACTATTCCTATATAGCCGAAAGGTTCTTTTTTTCCGGAGTAGTAAGTAACTACATGTGAAATAATTCCAAATCCTGGGAGGATAAGAATATAAACTTCTGGGTGCCCAAAGAAATCAGAACAGATGCTGGTAGAGAATTGGGTCCCCTCCTCCAGCGGGATCAAAGAAAGTTGTGTTTAGGTTGCGGA	141	151	470	480	10
2S43D:02280:07351	INITIAL_QUERY	CAGAAGATTAGCCTGGCAGTGCTTCAAGGCGTTTGGGTGGTGCGTTGAATGAATGGTGGTTTTTAGAAGACAAGAGCTGTTTCTTACCCGTCCGGTTAGCTTCAGCCTCCTACAGGAGAGGCCATGCCGAGACCCCGCAAGAGGCAGACTGGGACATATCAATTGCAGCAAGACAGTGAGAACTGTACCTGTGGCGAGTGTGTGGAGCTCGTGCTTGTGCTCGGAGCGTATGCCGTCCAAGGGTCCGCTGCAGTCCGTGCAGGTCTCGGACGCAAAGAAAACAGCCCACGGGCTGTGGGACCCCAACTGCAAAACGGGGGAAAATTGGGGCTTCCATCAAGGTGGAACGGACCGTCCCCTGGAGATGATCGAGCCGCGACACGCTGCAGTACAAGTTACTGGAGACTCATACAATAAAGCCTAGAAAGCCAATAGACATTATTGCTCATACTATTCCTATATAGCCGAAAGGTTCTTTTTTTCCGGAGTAGTAAGTAACTACATGTGAAATAATTCCAAATCCTGGGAGGATAAGAATATAAACTTCTGGGTGCCCAAAGAAATCAGAACAGATGCTGGTAGAGAATTGGGTCCCCTCCTCCAGCGGGATCAAAGAAAGTTGTGTTTAGGTTGCGGA	447	457	328	318	-10
2G5Z3:07981:01338	INITIAL_QUERY	GTAGTATATGTGTCTTATGGAGATGAGAACCTGCCACAGAAACAGGATGCGTCGTTTGCTTTGTTGTGGCCTGATCCGGGTCTGGAATGTGCTGCTCCAAGCTGTCAAACACCTCCATCAGGCAATCCTGAAGAAGTTGGGCTTGGATGTCGCCTGGTGCGAAGGCTGACATCTTCCGGATCAGA	31	41	24	14	-10
2S43D:04698:13096	INITIAL_QUERY	GTAGACATCAAGGGAATGGGCACTGTTCAAAAAGGAATGCCCCATAAGTGCTACCACGGCAAAACCGGAAGAGTCTACAATGTCACCCAGCATGCCGTGGGCATCATTGTCAACACTCTCCCATGGAGCAGCCGGAGTAGGGAGCCAAGTACTGAAGCGGGGCAGCCGATCAGAGGCAGAGGCTGACACCACGGATGGTGTGACTTCATGCACCGCATCGT	259	270	150	161	11
2S43D:06513:01166	INITIAL_QUERY	GCCACCCAGCCGCACTTCTCCATCCTGCAGGTCTTCCAGCGTGAGGTCCTCACAGGGAGGGCTGTCGGTACAACGTGATAGCAGAGCTGCTCGTTGTGATGCAGCTCGGGTGACAGCCAGCACTTCTTGGAACAGGCA	637	647	2	-8	-10
2S43D:09381:06904	INITIAL_QUERY	CGCTGCGAATCGGGAGCGGCGATACCGTAAAGCACGAGGAAGCGGTCAGCCCATTCGCCGCCAAGCTCTTCAGCAATATCACGGGTAGCCAACGCTATGTCCTGATAGCGGTCCGCCACACCCAGCACTCGGCTGCTCCTCTCCATCAGTATGATTCCACCTGGCCTTGCCCTGCCGCCTCGCGTAGCTGCTGTCAAACTCCGTCCCATCTTCTAGCTTTCCCGTGTAGTGCATGTGTAAAGACATCTCCCCTTTCTAGACTTGATAGGACCAGTTGGGTCCCA	92	102	128	138	10
2G5Z3:05996:10962	INITIAL_QUERY	AACACATACAAGCACAATAGATGCACAAGAAGTGAACGTTGCTAAGACAGAAAGTAATCACAATGTGCGTATCACAACTGCATTGAAGACACTGCGTTGTGCTCACATTCCCTTAAATATTGTTCCCAAAGTGTTCAGCCCCTCCAACTGGAACTCTGGGAAAAGGCTGACACAGTTTTGTAGAAAAAGACAAGAGGGGTAAGTAAAGGGGGTGGCAGGGAGGAAAGCAGGCCTTCAGTTAAAAAGATCAGCTAGAACATATTTTCCATCAGCTTCTATCAGCCTGACGATCTGGCTACCCTCTCATGTTTGGTTTGATTCTATTTTCCACCTTCCTTTTC	597	607	322	312	-10
2G5Z3:01461:13920	INITIAL_QUERY	GTGCAAGACTAGATGGTCACAGGTGGTCCCAGCTCGAGGGCAGGAGTCGCTCTTCTGTGGCACCGTCACCGATACCCTGAGCTTTGCCGTCAGGGTAGCTCGATTGTCCAGTCACTCTCCACCCTTCCATACTGGATATCAGTCAGCA	50	60	114	104	-10
2S43D:01409:08223	INITIAL_QUERY	AGATAATGTTTGGTTCTCCAGGCACCATATCTGCCTGGACTCTGCCATTGCTTCCCCACCATGATGATAATGGACTAAACCCCAGTCCAA	592	602	55	45	-10
2S43D:09226:04496	INITIAL_QUERY	CAGTGATTATTTTATGGACCAAGATCATGGAACTGTCACAGTAAAAGTGCAATATCTGTCCCACCACTCCCACTGGGGCCCCACAGGAGCTGCTTTGGCCCGACAGGCGGGAATCGTGGTGGCGGCGGTGTGGAATTACGCGCTGTCGTCGCGCTTCGTGTGGGGGCGGTATTAGAGTCGCTTTCGCCCAAACGCGATCATCCAGTCCCGTTCGGGCTGAGCTTGTCACTGGGGTGTAGAGGCGGGAGGATGTCTATGAGTTTGGAGGTTGGGCTGATGTTCACAGAGTTCCACATGCCAACCAGTACTACATAGTGACGAACCGTAACTGAGAGAGACCAAGGAGGACAAGGGATCAGGACTGTAGAGCCAGCTGTGTTTACTCATGTACTCCTGCGGGCCCATTAGTCTGCAGTTCAGCCAA	180	190	409	399	-10
2G5Z3:01661:07176	INITIAL_QUERY	CCTCCATGATGATCTGGTCCTCCTCCAGTTTCTTCAGCTTGGCCTCGGTGGTCACCTTCTCAAGCTGCAGCTTCTGCCGGGCGCTCTCCTCCTCCTCCAACTGCTCCTCAAGTTCCTGATCATGATGTTGAACACTCGGTTCAGCAACTCCTCATATGTGTAGTCTCTTTCTGAGCTGCCAGCAGTTGCTAGCTGAATGAAATGCCATCATCTTTTTTGCTGTCTTCATCTTCA	472	482	7	17	10
2S43D:08143:10064	INITIAL_QUERY	CGCGTCACTAATTAGATGACGAGGCATTTGGCTACCTTAAGAGAGTCATAGTTACTCCCGCCGTTTACCCGCGCTTCATTGAATTTCTTCACTTTGACATTCAACTCCGTGCCTGCAGCTCATCCTCCAGCTCCTCCAGCTGGGTCTTCATCTCCTCCACCTGCTGCTCCAAGGCCCGCTTGGACTTCTCCAGCTCGTGGACACTCTTGCCCACGTCATCCCCATCTCTAAGCCATCCTTAAAGAAAATCATGAATGGAGTCACACCATCTTCACGGTAGTCCAGGAGAGCAACCATACCATCTGGATTCATGTTTTCACCAATAAAAAACTGGTAGTTATTGAAATTAGCAAGGATGTGCTTAATCTGCTCTGC	616	627	301	312	11
2G5Z3:04587:06944	INITIAL_QUERY	GAGACGGGAATCGATGACATTCCGGATGTGAAAAATGACTTTGCTTTCATGCTCCATATGATAGACCAGTATGACCCTCTCTATTCCAAGCGGTTTGCAGTGTTCCTGTCTGAAGTCAGCGAGACGGGAAGGTCATGGTTAACTCCCCGGTGACTCGAGCCAGGCAACTGGGGCTGTGGCCACGGAAATAGGCATGGACATACTCAGTGAAGGCTGTGGCCACGGGCAGGGCGCCTGAGATCCCAGGACCACGTGGGCTGGGGGCCACCGGGAGATGCCCATGTCCCATCTGGGTGGAGAAGCTAGGCCGGATCGGGGGGGATGGTGGGGCAGACCACATCAAAGACAGCTTTCACAGTTGCGG	49	59	290	300	10
2G5Z3:10459:12351	INITIAL_QUERY	CATTATTTAAAATTATTAACCACTCATTCATTGACCTACCTGCCCCATCCAACATTTTCATCATGAGTAAACTTGGGTCCCTTCTAGGAGTTCGGCGATTAGTGTAATTAGTACGGGCTCAGGCGTTGGTGTTCAGGTATTAATTGCTTCAATATTAGGTCTTTTGAGTAGAACCCTGTTAGGAATGGTATTCCTGTGAGGGCGAGGCTTCCGATTACTAGGCATGATGATGTGAATGGTATGATTTTTGTGATGTTTTCCTATTTTTTCGGATGTCTTA	392	402	35	45	10
2S43D:07756:05904	INITIAL_QUERY	CCCAGGCATCGCTGAAGAAACTGCAGGCTCTGGCAGAAGTCTGACTATTCTCTGAAGTCTTGTTTTGGGATAAGCCAGTCCTGTGGGTTGGTACTGGGGTACATAAGGAGCCTGAAGACCAATGGCAGGTTTGCTTACAAGAAGCCACTCACTCAGAGATACAGCTGTGCACTGGATGCTGAC	572	582	2	-8	-10
2S43D:04241:14324	INITIAL_QUERY	CCGCTATTTTACAGATTAAAAAGAACTATTTGGAGCAGAAAGCCGTGGATGGATCAGCCCAAAGCCATAACAAATTATAAAGCCTACAACTCTATCCAGCAGTCAGACTCTTGGATCCTTAACAAACAATACTACATAATTTGGGCTAGAAAGGTAGCTCAGCGTTTGAGAGCACTGGCTGCTCTTCCAGAGGACCCGCGA	275	285	173	183	10
2G5Z3:06570:09688	INITIAL_QUERY	CTGGTTTGGTTTGGTTTGGGTTTTTTGTTTGTTTTGTTTTTGTTTGTTTTGTTTTGTTTTGTTTTTGTTTTTGTTTTTTGTAGACAGGGTTTCTTCTGTGTACTTGTCCCAAAGCTAACAGAGAGAAGATGACGCAGATAATGTTGAAACCTTCAATTAACCCCAGCCATGTACCGTGCCATTCAGGCCGGTTGCTGTCCTTGTATGCATCTGGGCGCACCACTGGCATTGTCATGGACTCTGGTGACGGGGTCACACAATGTTTCAGCCTGGCATTCCTTGTACCGGAACTGACAGATGAGAACTTTCTGCGGTGGCCACACGGGCGGCGCCCACTGCACAGTGGCCTCCAGGGTTGCTTCCTCAGAAATATCCACTTGAGAGAAGATCTGGGGTGTGTCTGGCTTCATTTGGGTCTCCAGGTTCACAGAGACAGACGGACCACAGAACGTAACTCCAGACATGATGGAGGAGATGTTATAAGAAAGCTACATGCTGCTATCCGAGAGAATCCACGTCTAATGGAGAACTTCTCTCAAGTGGATATTTCTGAGGAAGCAACCCTGGAGGCCACTGTGCAGTGGGCGCCGCCCGTCGTGGCCACCGGGTTAAGAAATAGTACGAAGTGTTCTCGAGCCCGCTG	215	225	593	583	-10
2S43D:00335:02868	INITIAL_QUERY	CCTAGCTGTTGTCTGCTACCTAGCTGCGGAGCAGGAGATGGCCGTGGACCCAACCTCCAGCAGGACTGCAGGGAACATCTCGACACAACTCCATGTTGCAGCCAGGGTTTGCATCCTCAGCTCCTCTCAGCTGTGATGGCTACCATAGCTCTTCCCTGGAGCCTGTCCCTCCAATTTCGTTTCTATGTGTGCACATGCATGTGCATCTGGCTGAGTGCTCCTATCCGGGTGTACACATGTGACTGCTGAGTGAACAGCCTGGATGTCATTCCTCTTGAGATGAATCTCTTCCTTTTTAGATGGTTCAGAACTGTGCGGAAGAAATGCGATCTTTTATTTATTTAATTTTTTGGCTTCTGTAATTCAATCTTCAGTTATAGCCCAGAGCAGGGAGCCACAGTGGTCACAGAACGTGGGCACCTTGTAATTGTGAACGTTGAACTTGTGTGGGATGTTGATGCCAAACCGCTGTTCTGCAATCTTGGCATCCACTTTGTTAATATTGTTTTGGCAGATGGCTCAGTGGGTAAGAGCACCCGACTGTTCTTCCGAAGGTCCAGAGTTCAATCCCAGCAACCACATGGTGGCTCACAACCATCCGATAACAAGATCTGACTCCCTCTTCTGGTGTGTCTGAAACACACACACACAGACACACACATATAACACACACACACAGACACACACATACAGAGTAGGGTAGATGAACTTTTGGAGCTGTAAGAAAGGGCATCATATTCATACTCATCTTCAACTTTCATCATATACATATACACACATATATCTACATACATACATACATACATACATACATACATACATGCCAGAAAAGCATGGATTGTTTCAGTCTTTCCAGTATTTATACTTGTAAATGCTTGCATGGAATGAAAGAAAAGAAA	611	621	823	813	-10
2G5Z3:01920:07905	INITIAL_QUERY	GTCAGCAATCATAAGACAGTCAGCCTACCCACGTTCACTTGGACAAACCTCACATTGAAGTAACCCGAGCAGGCATCAGTCTGTTGCATGACACTGAAACTGA	574	584	67	57	-10
2S43D:08368:04729	INITIAL_QUERY	GGTCGGTCCTCAGGATGTAGAAAGAGAAGTACTGGAGCCCCCAGGAGATCCTGGGGAAGGTAACCCAGCAGTGGGGCAGCCCTTTCATCTACATCCTGGAAGAGGCAGCTTGGTGTGTGTCGGGTGGTGAAGATCCTCTAGGCGACGAAAATTATAAAACTTTCAATATATTCTCCTCAGACCCCTATCCACACCATTAATTATTTTAACAGCTGATTAACTGACCAAGATAAACTCTCGGACTGTCCCAGAGACTCCTGGATTGATCTCATCTTCCTGGCTTCCTGAGCCCTGGAAGAACAATCGAAGAAGTCCTGGATCTCTTTCCTGCACGCCTCGTCGCGGAGGCGGAGATGATGACCCTTTTGGCTCACCCTTCAAGTGGGCCCCGGCCTTCTCCATGGTGGTGAAGACACCAGTAGACTCCACGACATACTCAGCACCGGCCTCACCCCATTTGATGTTAGTGGGGTCTCGCTCCTGAGATGGTGATGGCTTCCGTTGATGACAGCTTCCCATTCTCGCCTGACTGTGCCG	304	314	43	33	-10
2S43D:01153:01099	INITIAL_QUERY	GCTGTATGTAATTAGAACCTCCTGCCACTGCCATAGCTACTGCTGACTGCTGGAACCGCCATAGCCAGCCTTGGTTCCGGTGGTTTAGCAAAGTATCGGCCTCCACCACCATAAGGGCCAGAGCTCCTCTCCGATTAGGTGTATTAATAAGTGTCCTGCAGTAATGTTAGCTGTAAGCCGGACTGCTAATGTCATTGGTTGAATAAATAGGCTAATTGTTTCAATAATAATAAGTATTGGAATTAGTGAAATTGGAGTTCCTTACTTTCCTGAATGTATTGGAGCAGTGCCCCAACTGGAGGTTGACATCCCCTTGGTGAAATCTTACTTGGCACAGTTTGCAGCTCGTGCTATAATTTCAGAGTTGGTGAGCATTTCCGAACTAGCTCAACCACTGGAGAGTGGCACCCACTTCCCTAGGCGCGGGTGGATGTGGCTATGCACGCATCTCCTGAGATCACCTGCCTGAGGACCTACCAGAGGGGGGGAAAACGCAAAAGCCAGAGGCAGTAGAGTCTACCCACAAAGGCCGGGAAACGAAGAAAACATCACACAGGCCAGCTCAGAAAAGCCACTTCTTCCAGGATGCCTCCTTCCCTATCTGGAGAACAGCTTCCCCTAAAAACAGGGCCAAGGAGAGAGAA	183	193	152	142	-10
2G5Z3:07195:14955	INITIAL_QUERY	CGCGGCTATCGTGGCTGGCCACGACGGGCGTTCCTTGCGCAGCTGTGCTCGACGTTGTCACTGAAGCGGGAAGGGACTGGCTGCTATTGGGCGAAGTGCCGGGGCAGGATCTCCTGTCATCTCACCTTGCTCCTGCCGAGAAGTATCCATCATGGCTGTATGCAATGCGGCGGCTGCATACGCTTGATCCGGCTACCTGCCCATTACACCACG	200	342	0	142	142
2G5Z3:00911:07394	INITIAL_QUERY	TGTGTCCTTTGCGTTCCTCGTTTAAGCAAAAGAAGTTAGTAGCTAATTCTATCACGGAATGTTCTTGTCTGTGTACAGTTTTTTAGAACATTTAACAAAAGGATTTGTTTGCTTAGCTGTCAACAAAAAGAAAACCTGAGGGAGCATTCAGCAAGTCAGTTTTATGATTATTTTTCCTTTTCTACGTTTCGGAACGTGCCCA	143	153	122	112	-10
2S43D:07827:02165	INITIAL_QUERY	GTCTTGGAGATGATGGGGCGGGGTGGGGTGGGGTGGGGAAATCTTCCTAGGCTTTTAGGAGATTTCACTCCTCTTTTCCTGTTCAATGGTCTCTTTGGTCGGCAGGGTGTTCTTCTCCTGCGTCTCGGTTTTCTTCAGCTTGGCCTTATCGAGCTGGCGATTTCCCA	8	18	79	69	-10
2S43D:08353:08245	INITIAL_QUERY	AAGGGATTTGGGCAAGGAAAGGCACATCATTTCACCACAAGAAATAAAGACCCATAAATGGAGGTTAGTAGGTGGCAGCTACAGCTTTAGATCTTGTGGTGGTAGTACCCCCAGTAGTCAAATCAACTGTCTCTGAAACATTCATGAGCAAGCCCAGCATTGCTAAGAGGAGAGCGAACCAGCAAGAGACGGAACAGTTTTATTTCACGAAAATGATGGAGTACTTGGAGGGTAGGAACCTCATCACTAAGCTACAAGCCAAGCATGACATCCGTGTGAGTGCTGGGAATCAAACCAGGTCCTTTGGAAAGAGCAGTGAGTGCCTTTAACCACTGAGCCACCTCTCCAGCCGTCGGGTGGTTTCTCGTGGCAGTGTGTCCTTCCCACCTCTCCTCTCCTCGCTACCACCAGCGATCACTTTCTTAAAAGTTGACACTGTGCTCTGCCTCTGCCAACCTGGTGATCTGGTGTTTCTCTGAGATGAACTGCACACATTGAAGGGTTTCTATTTTTTACTGTGGGTTATTGCTTTTTAAAGAAACAATACATCTTAAAGCAACACTATCTATTTTATACATCCACAAGCAAAATTC	179	189	480	490	10
2G5Z3:06074:03474	INITIAL_QUERY	CATTTGTCCTTGTGGAAAGGCTCTCTTGCACTGCTGAGACTGCCCAGCCACAGTTAATATAGAATGCACAGAAACACTCAGGAACACACTCTAAGCACCTCAGTCAAAGTGAATTCCATGCCAGGTGCAGTCTGTAGCAAGGGCAGAAATGAAGAACACAGCAAGGTCCGTCTCCTCCACCTCTGGCTCTACCACCGTGACATCTGCTGCCACCACTGCTGCCACAGACATGACAAAGACTGTTAAGTCCTTTGTGGGCCCCACCCCGCTCCTGCAGTTAGGGGCATTGCTAGAACTACTCAGATTATGCAAGAACAAAAGACTCTTATATATATATATATATATATATATATATTATATATATATATTATATTAAAA	182	192	269	259	-10
2G5Z3:08766:10838	INITIAL_QUERY	TAAGCTTACAAAGAGCCATTCTTCTGAGTTGCTTTGTCTGTCTGTCTGTCTGTCTGCCTGCCTACCTGCCTCGTCTCCCACTCTCCCTTCTCTGCT	190	200	65	55	-10
2G5Z3:04395:05827	INITIAL_QUERY	GCTGGCCATGGTGGACACTAGCTCCTGGACTTCTTTCCGTTTTTTCACAGGTCGGAGCCGAGCATGTACTGCGGCGGCAGCACAGCGGACCCTTCAGCTAGTTTGCTGGAGCCAATGTCAGAGAGAGGCCTTGTATTACCATCAGAGACTCTGCTCCCCTCCTTCCCTCCCCCCGCTCCGTTTCCTACTTCGATTGGTGGGTAGCATGGTGGGCGTGTACAACGGCAAGACCTTTCCAACCAAGGTGGAGGATCAAACCAGAGTATTGATCGGCCACTTACCGTGGCGAGTTCTTCCATCACCTACAAACCCGTGAACGCAGCCCCGTGACCTCACCCACTAGCCCCTCTGCGACCAGTGAGCCTGAGTCTGTCTCAGCCACGGGAGAGGAGCTGACCTCTGAGGCAGGGGGGAGAGGACAGCTGTGAGAGTCAAGAGTCCTTAAAGGATGAAGAAGCGGATGAAGCCCATAATTATTCAAAAACACTATGCAAAGGAATGCAAGCTTAGAATCTCTGGACAAGAATCAAAGGAAATCATTGATGAGTGCCAGCCAGTTCGTCGGCTCAGTGAACCTGGGGAGTTGAGGCGAGAATATGAAGAGGAGATAAGCAGGGTGGAGGCTGAGCGACATGCACAACTTCATCTTGAAGGCGCGGAGCACTGTGCGTGAGATTGACCCCCAAAACGACCTAACCTCCTTCGAATTCGCTCCAAGAAAAATGAAATTATGGTGGCACCAGATAAAGAACTATTTCCTGATTGTGATCCAGAATCCAACTGAATAAGCCACTGTCTGGGCTTCCTGTGTCATTCCTTAATTTAATGTCCCCAATGGAGAAGTAGCTATTCTGGATTCTACAACCATTGAAATCTCAGAGCTTCCCATCCGAACGTGGACTCAGACATATAAAGAAACAGGTTCTAGAACCCATGTTAATGGAACTGAGAAGACACCCTCTCTAATAACAGACTAATAGGAAGTAACCATACAGATAC	615	625	849	859	10
2G5Z3:08154:04530	INITIAL_QUERY	CACGTCGAAGACTTACTGACCTTCTACCTCCCTTCCCAATGGCTGGATTCATAGGCTCTAAGCACGATGCTCAGATCCACAAGATGCTAGGTTCAGATTCAGAGCCTCACTCCTGCTAGAGTGCTATCCCTGACACTTAGGCTTTTTTTCTTTTAAGTTTCAAGACAGGTTTCTCTTGATACCTGAAACAAAAATAAGCACAAAAGGTATAAATGCCTAATGGAGGAAACTGAAACCCATCCTGTTGATTCTTTAAATTGTAAGTGTTCTACTTTGTGACAGTACAGATTGGTAGACAGCCTAGTTTTTTTAGTGATCTTCAAAATTTTAATTTGGATCCGTTCTCCACCTGGCAGCGGCCAGACACCTGGTAGCAGGTGCCAGGTTCCAGGTTCTGCATCTCAACAGGAGTCAGCCCATCTGTCTTCAGCTGGGGCTCCAGCCGGGTCCATGTTTCAGCCTGGCATTCCTTGTACCGGAACTGACAGATGATGTGTATCTGTGTGTGTGTGTATCGTGTGTGTGTGTGTGTTGTGTGTGTGTACTCGTAAA	617	627	42	52	10
2S43D:02895:14498	INITIAL_QUERY	TCAGAAACCTTTACAGAAATGGACTCTCACGAGGAGAAAGTATTCCGAGCAGTCAGAGAGACTCAAGAAACGTGAGGCTAAAGGCTGAGATGCGGCGTAAAAGCAAAGGGAATTACAACAGGCCCGAAGAGATGCAGAGAGACAGGA	337	347	33	43	10
2S43D:07550:10735	INITIAL_QUERY	TGGGCGACCTGGAGACTCCACCTGTGCTGTATCACCAGAGTCAGAAATACTCGCGTCGTGCAGGACGTGACAAATGGAAGTAGCACGTCTCACTAGTCTCGTGCAGATGGACAGCACCGCTGAGCAATGGAAGCGGCCAATATGGGATCGGCCATTGAACAAGA	0	21	143	164	21
2S43D:00269:08866	INITIAL_QUERY	CTCCCTACCCCATTTCTTGAAAATAGACATTGTTTAGATCTAAAAAGTCCCACCTCACGTTTCCCCCAAATGACCGGGAAGTACCCCAAACCTTATTCGAACTAACCAACCAGCTCGTCTTCTCGCTCTTCCACCCTGCTGTTCCAAAGCTGCAGGATCTCTATGACACAGCGCAGCAACAGGATAACTGGAGGGAGTCCTGATGAGGAGCCAACATTGTTGTTGTCACAGAAGCTACAGCTTCCACGACCTTAGCTTCTTGTTTTCTTTTGCGGTACTCTACAGGATACCTTTTTCCTTTGTCGGTGGGGTTCTGAGGAGCAGGATGGGACGTCCTTCCTCGTGCTTCACGATACATACTATGTAGTAGCCCATTTCCACTATGTTCTATCAATGGGAGCAGTGTTTGCTATCATAGCAGGATTTGTTCACTGATTCCCATTATTTTCAGGCTTCACCCCTAGATGACACATGAGCAAAAAGCCCACTTCGCCATCATATTCGTAGGAGA	303	313	151	161	10
2G5Z3:09317:12651	INITIAL_QUERY	CTTCCCTCAGCTGATGAAGATGCGCTACTTGGAAGTGTCAAGAGCCTCAAGACATCGAGTGCTGCGGAGCCCTGGAGTACTACGACAAAAGCCTTTGACCCGCATCCACCACAAGGAGTGAGTAAGCCCCCTGCAGGTGCTTTCATCCTGGCCAAGTTGCTTTTCATCCTGATCAGATGGAAGGTGACCAGCAGACTTACCACCATCTCTCAGGCAAGCCAACATTGGAG	466	476	164	154	-10
2S43D:08277:04503	INITIAL_QUERY	GTTGGTTCAAACACCCCTGCTTGCTTGTTGTCTCGTGGTTCCCATGGACCAATCAAGACCAATCCACTTTAGATTTTTACGTTCCGGGTTCACTTGAGCCTCATTGTGAAAAGCTCTTAACTTTGGCAATCCCAGGTCGGTGGAGTCCTGGGCAGCATTCACTGCCAGTGTATTAGGATCACAAGCAGAGATTCTTGACAAACTCTGCAACGTGTCTCCGCTCAGCAGAAGGAACGGATG	148	158	192	182	-10
2G5Z3:03168:02201	INITIAL_QUERY	CAGGTAGCCGGATCAAGCGTATGCAGCCGCCGCATTGCATCAGCCATGATGGATACTTTCTCGGCAGGAGCAAGGTGAGATGACAGGAGATCCTGCCCCGGCACTTCGCCCAATAGCAGCCAGTCCCTTA	270	280	119	109	-10
2G5Z3:08944:03887	INITIAL_QUERY	CCCATCTCAGTCACCTCAAACCATCAGAGCATGCTCAGTCCTCAGGTCACCATATGGCCCCGAGCTCTCTGCCTTCCCCCGCCGCCAGCCCCGAGCCCGAGCCCGCGATCCCAGCCAACAGCCCGCAGAGCAGCCCCAGCCAGCAGCGCCCGAGGCCGGGTGGAACGCCACATCGACACCTTATGGCGGCGGGACA	94	104	125	115	-10
2S43D:10459:07134	INITIAL_QUERY	CGATCGCCGGTGCAGTCATGAGCCCCGCCTCCCCCTGGTGCACGGAGAGGGCGGGGCCTGGGAACAAGGCTGCTTCGTGACCCACTATGTCTTCCCCACAAGTTCTCCTGGACACTCCCGTGCCTCGGGAATGGGTTCTTCCTCAGCCAGTACCTCCGCCACGCCAC	560	570	74	84	10
2G5Z3:01661:03243	INITIAL_QUERY	GCAAGATCACTGTCACTTCAGAGGTGCCTTTCTCCAAAAGGTATTTGAAATATCTCACCAAAAAATATTTGAAGAAGAACAACCTCCGAGACTGGCTGCGTGTGTCGCCAACAGCAAAGAGAGTTACGAGCTGCGTTACTTCCAGCACTAACAAATAATATACATACCCCTTCATCCTTCTCCTCCCTAATGA	274	284	89	99	10
2G5Z3:07442:05474	INITIAL_QUERY	AAACCGTCTGTAACCCATCTTTGGGAATTTGATGCCCTCTTCTGGAGGTACCAGGCATGCATGTGGTGTACAAATATGTGAGCCAAACACTCATATACTTAAAATAAAAAGCTAGTACAATTAAAAAAAAAAACCACAGAAGACACCAGGTGACATATTTCTAGGTAGGCTCATACAATAAAAGCCTAGAAAGCCAATAGACATTATTGCTCATACTATTCCTATATAGCCGAAAGGTTCTTTTTTTCCGGAGTAGTAAGTAACTACATGTGAAATAATTCCTAAATCCTGGGAGGATAAGAATATAAACTTCTGGGTGCCAAAGAATCAGGAAGCAGATGCTGGTAGAGAATTGGGTCCCCTCCTCCAGCGGGATCAAAGAAAGTTGTGTTAGGTTTGTAGAAAGAGCAGCACAGCTGGCCATCAGAGTCACCAATCCCAACGCCAGGCTACGCAGCGAAGAAAATGAGTAGATGGCTGTGTGCATGTTTTATTGTTTAAATTAAAATACACAAAACCTGCAAA	141	151	235	245	10
2G5Z3:07442:05474	INITIAL_QUERY	AAACCGTCTGTAACCCATCTTTGGGAATTTGATGCCCTCTTCTGGAGGTACCAGGCATGCATGTGGTGTACAAATATGTGAGCCAAACACTCATATACTTAAAATAAAAAGCTAGTACAATTAAAAAAAAAAACCACAGAAGACACCAGGTGACATATTTCTAGGTAGGCTCATACAATAAAAGCCTAGAAAGCCAATAGACATTATTGCTCATACTATTCCTATATAGCCGAAAGGTTCTTTTTTTCCGGAGTAGTAAGTAACTACATGTGAAATAATTCCTAAATCCTGGGAGGATAAGAATATAAACTTCTGGGTGCCAAAGAATCAGGAAGCAGATGCTGGTAGAGAATTGGGTCCCCTCCTCCAGCGGGATCAAAGAAAGTTGTGTTAGGTTTGTAGAAAGAGCAGCACAGCTGGCCATCAGAGTCACCAATCCCAACGCCAGGCTACGCAGCGAAGAAAATGAGTAGATGGCTGTGTGCATGTTTTATTGTTTAAATTAAAATACACAAAACCTGCAAA	239	249	409	399	-10
2S43D:06246:09986	INITIAL_QUERY	GCGGAGGTGTGCGATGCTCTGGTTTCAGGCCCTCTCTTGGCGTGGATGGCACACAGATTGGTATCTTCAAACAACCCCACCACGGTATGCTTCGCTAGCCTCCTGAAGGGCACCGATGGCTGCACTTTGAAACCTCAAGTCGGTTTTGAAATCCTGGGCGATCTCCCTCACCAATCTCTGGAATGGCAGCTTCCGGAACACGAGTGCCTTTGTAGAAGGAGTGAAAATGCGCACATATAGCCCTCATGGATCGTCCCAATGCCAAGGACATGGAATCCCGGATCCGGCATTTTCGGA	111	121	192	182	-10
2G5Z3:04357:00705	INITIAL_QUERY	GTGCACATAGCGCAGGGGAGAATCTGGTGTTACACAGAGGCAATGGGTGGGCAGGTTGACATAAGAGGCCTCTGTGAGTGGCTGATGGTCAGCCCTGGGATCGGTCACCACTAGCAAGCCGTGGCTCCTAGAAGGCTGC	126	136	8	18	10
2G5Z3:06950:11373	INITIAL_QUERY	GTGCCAGTCAATAGCCGAATAGCCTCTCCACCCAAGCGGCCGGAGAACCTGACTGCGGTCTATCTATTCTGAGGCTTACTTGCAAGCCTGTGGTTCATACCTACTACGTGCATAGGAAAGAGCTATTGAGGGCGTGAAAGGACTATAAACAAAGTCCTCCATTGGGGGCCCTGTGTTCCTTCCTATAGATGACTGTGAGCATCCACTTCTGAATTTTGCCAGGCACTGGCATAGCCTTGCAGGAGACAGTTAAGCGGTATCGCTGGACCACGGATCGCAAAGTGCATCTAGCTACCGGTAAGGTCACCCACTCTTCCTCCATGTACCAGACTGCCCCTATCCTCTGCTAGGAAGAGATTTGCTGACTAATAAAGCCAAACTCCACTTTGAGGGATCAGGAGCTCAGGTTGTGGGA	32	42	41	31	-10
2G5Z3:08828:07439	INITIAL_QUERY	GTGGAAAATTTAGAAATGTCCACTGTAGGATGTGGAATATGGCAAGAAAACTGAAAATCATGGAAAATGAGAAACATCCACTTGATGACTTGAAAATGACGAAAATCACTAAAAACGCAGCATGTTAATTGAAGCTTGTTGAGCTTAACAAAGGTGCCTATTGAAGATCTGTCGAAAGACGAAGGAGCTGCCAGAACCTTTACGAACCCTTTGGGTGACCCTATGCTGAGCGAGTTCAAGAACCTGGACATCACTAAGAAGAAGTTGGTCCATGAAGGCCCCCTCACGTGGCGAGTGACCCAAAGACAAAGCTATAGAAGTGCACGTGCTCTTGCTGGACGACATTCCGCCTGCTCTGCCTCCCAAGTGCTGGGATTAAAGGCATGCGCCACCACTGCCCGGCTTCTGATTCTTATATACAGCTGTTTGGCTATTGACTTCTCTTGGTCAGGGCCTCGGTGAGCAGCACAGGGTGCTCCTCAGGGGCCACACGCAGCTCATTGTAGAAGGTGTGGTGCCAGATCTTCTCCATGTCGTCCCAGTTGGTAACAATGCCATGTTCAATGGGGAGTCCTCTCTTAGTGTTAACTGGTGAGGTAGAAGGATGGTGCTGGGACCTGGATTTTGTTTTCGGGGTGGGATAAAAGGAG	8	18	557	547	-10
2G5Z3:06699:14174	INITIAL_QUERY	GGGAAAGGGACCTGGTCTCTGGAAAGGGGCGACTAGACAGATGTCTCCTAAAGGTAATGGTATCAAATGCCAGGCAGGAGGAAACCCTCGTGGGGAAGGAGCTCAGGCAGATCCCTGAGCCACAAAAAGCCAGATACCCAAGTCCAAGGCATTAGTGATGTGCAGCGGGGCTGAGATGAGGGAGAGGAGCTCGGAGACGAGAAATATGACAACTCACTCAAGATTGTCAGCAATGCATCCTGCACCACCAACTGCTTAGCCCCCCTGCCAAGGTCATCCATGACAACTTTGGCATTGTGGAAGGGCTCATGACCACAGTCCATGCAAAAGAATCAGAACTACTGAGCAGGAAGGCCTCCCCTGCCTCTCCACCCATCTGATGGTCTGGCTAGCAGAGAGGAAAAGAACTTGGACATGTTGGTGAAGGAAAAAGCGTGGGTGGGAAGATGGATGAAATAGAGAGGAAAATTCAAGAGGGAAGAGCAACTAAGACATGCACTGAAGTGGAGAAGATGTGACAGCAGCAGCCCATGGGTGGAAGGGTTTCCCGACAGGCAGGCCATGGTGGTCATTAATAAATAATGATGAAGGACCAAGGATGAGCAGGGCAGATATGTACAGTGCCAGCCA	49	59	365	355	-10
2S43D:09795:12083	INITIAL_QUERY	TGACAGCCTGCCCCCTGGCACCGTGAAGCTCTAGGAGTGCCTGCTTGCCTTCCTGGCTGCTCACTGCCCCAGGGATGTGCCTGCTGCCACCACCACCTACACCACCTGCACCTGTGCCACGGAAGTCTGTGACAAGCCTTAACTTATGTGTTTGGACAAGCTGTGTTTTTGGTTTTGGCTATCGGTACACTGGTAACTCAGGCCACATTATCCACTGATGCCAACACGGCCAGTGCCCAGTTACATTCAGAGGCCGGACTATGCTGACCATCCTTAGGAATGTTCTGAATCGGAGCGGCTCTTAAAGGTACCTCTAGACTCGCAAGAAGCGGTGCTCTTTTGCCTGAGTCGAGTTGGGGTTGGCATCTGGGTACTTGGTGAGGTCGAAAGTCAGGACTTTGCTGATCACACAGTCCCCTTGCTCAGGATAGACTCCAATGAGGA	576	588	37	49	12
2G5Z3:08254:08775	INITIAL_QUERY	TTCCTCTTGTTCGTCTCTCCTAAGGAGTTCGTGCAGAACGTCTCCCACCGCTCCCTGACTTCATCGGGAAGATCTTTGGATGAGCTGCTGTAGTCGATGCCATGTTCATCGCTTATCACCTCCCAGAACTTAGCACCGATCTGGTTGCCACACTGTCCGGCCTGGATGTGCACGATTTCCCTCATGCTACGGTTTACTACATCAAGAAGGTGGTGAAGCAGGCATCTGAGGGCCCACTGAAGGGCATCTTGGGCTACACTGAGGACCAGGTTGTCTCCTGCGACTTCAACAGCAACTCCCACTCTTCCACCTTCGATGCCGGATCCCAGACGTCACTCCAAACCTCCACTCCATATCAATCAGCTGGTTAACCATCAGGGTCTGACCCATGGCCCACTGTGCAAGGGTCGAGGCGTTCTGCTTCCACTTTCAGAAAAGTAAGTGGCTTTCTCCTCGCTAAGACA	563	574	382	393	11
2G5Z3:08254:08775	INITIAL_QUERY	TTCCTCTTGTTCGTCTCTCCTAAGGAGTTCGTGCAGAACGTCTCCCACCGCTCCCTGACTTCATCGGGAAGATCTTTGGATGAGCTGCTGTAGTCGATGCCATGTTCATCGCTTATCACCTCCCAGAACTTAGCACCGATCTGGTTGCCACACTGTCCGGCCTGGATGTGCACGATTTCCCTCATGCTACGGTTTACTACATCAAGAAGGTGGTGAAGCAGGCATCTGAGGGCCCACTGAAGGGCATCTTGGGCTACACTGAGGACCAGGTTGTCTCCTGCGACTTCAACAGCAACTCCCACTCTTCCACCTTCGATGCCGGATCCCAGACGTCACTCCAAACCTCCACTCCATATCAATCAGCTGGTTAACCATCAGGGTCTGACCCATGGCCCACTGTGCAAGGGTCGAGGCGTTCTGCTTCCACTTTCAGAAAAGTAAGTGGCTTTCTCCTCGCTAAGACA	574	584	216	206	-10
2G5Z3:01521:11892	INITIAL_QUERY	CTAACACATACAAGCACAATAGATGCACAAGAAGTGAAACCATTTGAACTATTCTACCAGTGTAATCCTTTATCATAATTGCTCTCCCCCTCTCTACGGCATTCTATATTATAAATTAGACGCCAGAATATACTGCAGTCACTGTAATTCGATAGGGGACCCCTCCTTTGAACTCCCCTGGTAACAATGTGCTGAGGTTTCCAGGGGGGAGACGGGTCCAGTTGAGATGAAAAGGTGCCGGGCCCTTCCTCCAGTGAGAACCAAGAGGGGACACTTACAGACTCTATGAAGAATGAGAAGGATGATCTTTATAAGGACAGTTCTGGAAACACCAGTGCAGAGAGCAGCCACTTCTTTGCATATCTAGTGATCCGCTGCCTGTTGTTGAGATGCAGAACCTGGAACCTGGCACCTGCTACCAGGTGTCTGGCCGCTGCCAGGTGGAGAACGGATATCCATGGGGCGAGTGGAGTTCGCCCCTGTCCTTCCAGACGCCATTCTTAGATCCTGAAGATGTGTGGGTATCGGGGACCGTCTGTGAAACTTCTGACCGGGAAGAGCTTCACTCAAGATTTCATGGTGCATTTCAACAGACTTGAACTTCAGGTTGTTACAATTGACTGGAGCAAAGGTAACCACCATGCCGAGGCTTGAGTGGTGCTGCTTTGATAATGTTGTCCACTCGCAGGATCACCTCTGCTGCTTCAGCCGCACTCAGAAGAACCTGTCGCTTCACTTGAAAACTCTCTGTTATACCCAGTACTGCCATATCGCCGATGGTACCTTCCTTCATATCCAGA	470	480	298	308	10
2S43D:02398:01639	INITIAL_QUERY	CACCTCTATCAATCCTGAACTGTCCATAGCTGCACTGGTCCAGGTCCACCATCTTCTGCCTTCAATGGCCTTACTAGCCACTTCTTGACCATCTTTCTTGGACCTCTCTCCAACATAAGTTGGGTAAGAAAGCAATCCTCTATAACCGCATCGGAGACATCGGATTCATTTTTAGCTATAGTTTGATTTTCCCCTAAACATAAACTCATGAGAACTTCAACAGATTATATTCTCCAACAACAACGACAATCTAATTCCACTTATAGGCCTATTAATCGCAGCTACAGGAGAGTGCCATTGGTAGTGGAGTGGAGCAGCCCAGCTCCGCCCTTGCTGGCGTGATCGGGAAAATCCCGCCTACCTCAGTGCCTTACCTCATGATTGTGGTGCCCGTTTGCCACCTCCAGTACCCCAAAAGTGTACAAACAAAAACAATTCCTTCAAATAGCTTGCTTCAAATACGATTCAGCCAACTGCATGTCATTAGGAATTATGAGGCATTGTCTCTGCTCCTGTGCCCAAGAAGCTCCTGATGATGGCCGGTATAGATGACTGCTACACTTCAGCCAGAGGCTGCACTGCCACCCTGGGCAACTTTGCTAAGGCCACCTTTGATGCCATCTCCAAGACTTACAGCTACCAATGGATATCCGTTCTCCACCTGGCAGCGGCCAGACACCTGGTAGCAGGTGCCAGGTTCCAGGTTCTGCATCTCAACAGGAGTCAGCCCATCTGTCTTCAGCTGGGGCTCCAGCCGGGTCCATGTTTCAGCCTGGCATTCCTTGTACCGGAACTGACAGATGAGAACTTTCTGCGGTGGCCACACGGGCGGCGCCACTGCACAGTGGCCTCCAGA	6	16	60	50	-10
2S43D:01832:12658	INITIAL_QUERY	TCAGACCAGTGCTGAGTCTTGGGGTACTGGCAGAGCTGTGGCTCGAATTCCAAGAGTTCGAGGTGGCTGGGACCCACCGATCTTGGCCAGGGTGCCTTTGGGAAATATGTTGTCGTGGGGGACGCATGTTTGCACCAACCAAAACCTGTGAGCACTAAAGGTCCCCCTGAGAAACGAATGAGACTCCAGTGAATGTTGGACGAGGAAGAAGCTGGCCAGCTCCTTGTCAGTCGCTATACCTCAGCACCGTGGGAGGCTCTTGAGCCTGGAAACACTATCGCAGTTTGTACGGAATGCACTTGTTCTTTACAAAAGGACGTTCTAGGTTGCTTCCTCAGAAATATCCACTTGAGAGAAGATCTGGGGTGTGTCTGGCTTCATTTGGGTCTCCAGGTTCACAGAGACAGAGGACCACAGAGGGCCCGTCCCTTTTGTGTCCCCCAGATGAGGAGTTTTGCCTTTTTCTGCTTCTGCTGCATGATCTCCGAGTCCCTCTGCTTGCGGGCGGCAGCAGAAAGCCATCATCTCGGCGCTTCCCTTAACCGAGTCGCTCTGCTTCTTCATGTTCTTCTGGCGGGCGAGCTCTCGCTGGTTACCGCGAGTCATGAGTGAGCTTCTGTACACACCAGAAAAAGTTTCAAACCTTT	521	531	259	249	-10
2G5Z3:09896:08090	INITIAL_QUERY	CGATCTCCAACTGATTCGTCCGCTGGCTTGGTTCCTTAATCACCTGCATCAAACTGTTCAGGCCACGCCCCAAGAGCTCCTGCTTCAGTCCGAGCAGGAGTTGGAAGTCCTTAGTGTTCTGCCCCCTGGATGGCAGCCAGATGAACCCGTGGTCCCCAAGGCCATTTTCTTCTTGTGCCCTCCACCCGACGAAGTCACGGGGTACGGCATGGGCAGATGGTTAACCATCATGATGTGCTGGTTGGCCTGATACACGGCGGTGGGGGTCTGCACACCGGGACGGATGGAAGGACTGCTGTTTGGGATGGCAGCTCGGGGAGGCTGGATTTGAGGCCTCTGGAAAAACGGAGACCGGGCCTGAGGTTGTGAGTTCATTGTCTGAGGTTACGATAACATTGTAAATTTGGTCATCTCCTAAAAGTGCACCTGGTTGACCTAATTCTGCTCGAATTAAAATACTTAGTGCAGTACCCACTATTCCCGCTCCAGGCTCCGAATAGTAGATAGAGGGTTCCGATATCTTTGTGATTGGTTGAGAATAATCAACGA	445	455	280	290	10
2G5Z3:09896:08090	INITIAL_QUERY	CGATCTCCAACTGATTCGTCCGCTGGCTTGGTTCCTTAATCACCTGCATCAAACTGTTCAGGCCACGCCCCAAGAGCTCCTGCTTCAGTCCGAGCAGGAGTTGGAAGTCCTTAGTGTTCTGCCCCCTGGATGGCAGCCAGATGAACCCGTGGTCCCCAAGGCCATTTTCTTCTTGTGCCCTCCACCCGACGAAGTCACGGGGTACGGCATGGGCAGATGGTTAACCATCATGATGTGCTGGTTGGCCTGATACACGGCGGTGGGGGTCTGCACACCGGGACGGATGGAAGGACTGCTGTTTGGGATGGCAGCTCGGGGAGGCTGGATTTGAGGCCTCTGGAAAAACGGAGACCGGGCCTGAGGTTGTGAGTTCATTGTCTGAGGTTACGATAACATTGTAAATTTGGTCATCTCCTAAAAGTGCACCTGGTTGACCTAATTCTGCTCGAATTAAAATACTTAGTGCAGTACCCACTATTCCCGCTCCAGGCTCCGAATAGTAGATAGAGGGTTCCGATATCTTTGTGATTGGTTGAGAATAATCAACGA	601	611	159	149	-10
2G5Z3:05778:10260	INITIAL_QUERY	GTGGAGTCACACAGGCAACAACTTCACTGAAAGGACCTGCACCTACAACACTCATAGCCTGGACTCTGCAGTAATAGGTAGTAGCTGGTGAAAGTCCTTTTAATTCACAACTGAGAGCCAGAGCTAACAGAGAAACCCTGTCTTGAAAAAAAACAACAACAACAAAAAAAATCAAAAGAAAACAAAAACACAAAAAAACATATTTTGCCTTCCTTCCTTGCTCCTTTCCTTTTATTCCTTCCCTCA	324	334	215	225	10
2G5Z3:05050:05307	INITIAL_QUERY	CCTGAATGAACTGCAGGACGAGGCAGCGCGGCTATCGTGGCTGGCCACGACGGGCGTTCCTTGCGCAGCTGTGCTCGACGTTGTCACTGAAGCGGGAAGGGACTGGCTGCTATTGGGCGAGTGCCGGGGCAGGATCTCCTGTCTCTGTTCTTTGTGGCTCATAGCTGTGGAGGACTTGGCTTTGTGAACTGATGTTCACGAGAAAGCAGATGTAAAATAAGGTGACTGTCTGTGCTACACGTAATTACTGTTGTACAATCTGCTCATCAGTCGTCACTGGATTTTCTTCATTTGTTGAATAGTCCAGGTGGTCCATCACCTGATAGCTGCTGCCTTTCCAGAACTTTTTCATTTCA	174	294	0	120	120
2G5Z3:01159:12095	INITIAL_QUERY	CGGCCGCAGTCGATGAATCCAGAAAAGCGGCCATTTTCCACCATGATATTCGGCAAGCAGGCATCGCCATGGGTCACGACGAGATCATCGCCGTCGGGCATGCGCGCCTTGAGCTGGCGAACAGTTCGGCTGGCGCGAGCCCCTGATGCTCTTCGTCCA	479	489	149	139	-10
2S43D:01263:10935	INITIAL_QUERY	AATACACCCCTGCTACCCGTTAAGAAACCAGGAACTAACGATTATAGGCCTGTCCAGGATCTGAGAGAAGTCAAACAAGCGGGGTGGAAGACATCCACCCCCACCGTGCCCAATCCCTTGCCGGCAGACTCGCCGCCATCGGGCCGTGTGATCGAGGGCACTCGCCCATCTCTCAGGACCGACTGACCCATGTTCAACTGCTGTTCACATGGAACCCTTCTCCACTTCGGCCTTCAAAGTTCTCGTTTGAATATTTGCTACTACCACCAAGATCTGCACCTGCGCGGCTCCACCCGGGCCCGCGCCCTAGGCTTCAAGACACTTCTCTAAATTTATAAGCATTCCCCAAATCTCTCCATTTTCTGGTTGTCTTTCAATCTTTAAAGGGATGAGGATAATAGACATAGTTGTATGTGCACAACAGAGGCACTGAACGCAATGGGGAGCAACAGCTGATCAAAGATGTCTGCCCACTAGGACAAATAGTAGTACTAGCATCTGAGTTTGGGA	79	89	415	425	10
2G5Z3:03362:01842	INITIAL_QUERY	CCCGGTCACACTTCGGCTGGTCGTGCCCGCCACCCAGTGTGGCTCCCTGATCGGCAAGGGCGGCTGCAAGATCAAGGAGATCCGCGAGAGCACCGGGGCCCAGGTCCAGGTGGCGGGGGAGATGCTGCCCAACTCGACCGAGCGGGCAACGTTGGCTCTCGCATTATCCCCTGGCACGCTACAACATTGCATGTAACACACCCTGCCCAGTGTAGCATACACATTATAACGTTTATCTAGGACTTCCCCGAGTGTTTCACACAATGCCAGAGCTGTGTCTTACATGCTTGAGCTCCTCGTTCCTTCCGCAGTACCACAGAACGGGTTCGACCCCCAGGTCCCACCGCCTCAGTATGAAAGGAAGAGTTTATTGAGGAGTGGTATGACAGGCAGAGAGGATGCCCCAAGGTGTGGCTGGGGACAGCCATCGTCAGGGCTTAAGACAATCTTTTGAGACTAGTTGGTGAATTAAGGAATGTTTGCTCTGGAGGAAGAGGAGGCGGCTGCGGAAAGGGTCTGGGTCTGGGTTTGCAGATTAGGAGACAAGGAGTTGGTTACCGCTGTCACCAAAGCCAGCAGCTTTAGCGGAATCTCAGTCCTGACAAGAGGTGGATACAGCTACGTGGAAGCAGCAAAAATGCATGGACTAAGGCATT	368	378	58	68	10
2S43D:00478:12058	INITIAL_QUERY	GTCGAGAGGTCAACGACTCATGAGAATTCCACTTATGGAGTGAATAGCAATGACATGATGAGCTGACAACTCTTCGGACTCTACCTTGCAGAGCAGCGGTTCCCCTTTGGTCTGGTGCCAGAGGGTCAACAGTTGCAAGGAAGGCCCGGTTCTCTGCAGCCTCCGCGGGCCACTTCCGGTCCCCCGCCGCTCCGGAGCGCTCGGACGCGGGTAGACGAGCTGCCCAGCGTGGCGATGCTCGCACAACTGCTTCACGTGGGGAGGTGGCCGGTGGCGCGGCTCATCAAAGGATGTGCACAACCTTATGATCCCACTTTTATGATGAG	137	147	143	153	10
2G5Z3:07056:13352	INITIAL_QUERY	GTGGAGGTTTGTTTTTTTTTTTTTTAATATTTATTTACTTATTTATTAATATGTAAATACACTGTAGCTGTCTTCAGACATTCCAGAAAGAGGGCATCCAGATTTCGTCCAGATAGTAGGACCCGTCGCTCGTCTTCTGGGTGGTATTACACAGGGCCTGATGGGTTTTGGGAACTGCTCCTACGCAGAGTCCCCTGTCCGGTCACTTCGGACAGGGTCAGCTTGTGTTGGGAGGCCACGGAGCA	162	172	193	203	10
2G5Z3:07056:13352	INITIAL_QUERY	GTGGAGGTTTGTTTTTTTTTTTTTTAATATTTATTTACTTATTTATTAATATGTAAATACACTGTAGCTGTCTTCAGACATTCCAGAAAGAGGGCATCCAGATTTCGTCCAGATAGTAGGACCCGTCGCTCGTCTTCTGGGTGGTATTACACAGGGCCTGATGGGTTTTGGGAACTGCTCCTACGCAGAGTCCCCTGTCCGGTCACTTCGGACAGGGTCAGCTTGTGTTGGGAGGCCACGGAGCA	476	486	104	94	-10
2G5Z3:00958:10199	INITIAL_QUERY	GGAGCTCCGCAGTCACCGACGGGACCAGAAGTGGCATGACAAACAGTACAAAGAAAGCCCAACTTGGGCCACAGGCCCTGAAGGCCCAATCCGGTTTGGGGGTGTCCGGTCCTCACTGCAAAGGGGAATTATGGCTTGGAAAAAGTAAGAGAAGAACCTTCTAACCCTTTCCTGGCGTTTGTGGAGAAAGTGGAACACAGCCCTTTCAGCAGCTTTGTGTCTCAGGCATCAGGTAGCTCTTCCTCTCTACCTCTGTCACCTCAAAGGCAACAGCCAGCTGGCCTGAGTGTTTTTGTTCCCATGTTAAAGATAGAGTAAATGCAGTATTCTCCACATAGAGATATAGACTTCTGAAATTCTAAGATTAGAATTACTTACAAGAAGAAGTGGGGAATGAAGAATGAAAAATTACTGAGGGAGACAGAGGCAGGTGGATCTCTGAGCTCAAGACCAGCTTCATCTACATAGTGAGACGCCCATCTTGAAAAAGGATGAAGTTACCCTCTCTCCTTCTCTTCTCTCTCTCTCTCTCTCCAGGTACTGCAGCAGCTTGCTCATGCTGGACACCGGGGATGCCAAAGGACTGCACGAAGAGCAGCAGCTGCTGGGGCCTCCAGGTCCGTATACCCCAAGACCCTGTTTTAAGAGAGTAATACAGGAGAAACTAGATTGGTTGTCACAAAGTGGGCTCTTCCCTCGTGGTGGGAATGCTTATAACTACTAACTCTGCTCCAGTGGAGCAGGTTCCCGGGGGAAGCCTGCCTGCCCCCGTCCCCA	482	492	587	597	10
2G5Z3:10056:05380	INITIAL_QUERY	CGTCCGGTGAGCTCTCGCTGGCCCTTGAAAACGGATATCCATGGGGCGAGTGGAGTTCGCCCCTGTCCTTCCAGACGCCATTCTTAGATCCTGAAGATGTGTGGGTATCGGGGACCTCGTGTGTGTAGTAATGCCGCCAGAGCGGCCGGATCTTGTCCTGGCCGCCCACATCCCACACGTTGAACTTGACGTTTTTGTAAGTCACCGTCTCCACGTTGAAGCCCACAATTCACTTAGAAATCCAGATGGGAAGCAGAGCAAGGGGTTAGGACCTGGCTCTAGCAGCTGGGCCTTCAGAGGGTTGCTCTGTGTGGCCTGTTGGGCATAGATGTGTCAGGACTCCTCTTATCCCCTGTCCCCCAGGCCTGCCA	39	49	140	130	-10
2G5Z3:02751:11444	INITIAL_QUERY	CCCTGCCAACATTAGATGTGTTCGCTGGCTGCCAGATTCCGTACCCCAAAAGAGAATTCCTTAATGAAGATGAACCAGAAGAGAAAGGTGACAAGAACCAGCCACAGCAGCAGAACCCACATCAGCAACCTGCAGCCCCCGCAGCCATCCTGACTCTCCAGAACATTACAGGCACGTCAGAAGGGGAAGCTAGCACACGCTGACTATTTGCAGAAACGAGCTGCCACCATTCGACTGCAGGCTGCATTCAGGGGGATGAACTCGCATCGTTCACGTATGAGACGTTGCAGGGCTCACCGGGCTGTGATGTCACTGCTCATTAGCATAGCCCCACCTCTTGGAGAATTAGCATCATAGGGGCTTCATTTGCATGAATCCAGGACTCATTTGCATAAAGGCCACACCTCATTTGCAA	617	627	370	360	-10
2S43D:09550:04059	INITIAL_QUERY	GCCCCAGCTAACTGCTCTGTGGCCTCTCAACACAAATTGACCTTGTCCGAAGTGACCGGACAGGGACTCTGCATAGGAGCGGTCCCTAAAACCCATCAAGTCTTGTGTAATACCACCCAAAAGACAAGCGATGGGTCCTACTATTTGGCCGCTCCCACAGGAACTACCTGGGCTTGTAGTACTGGACTTACTCCCTGTATCTCAA	162	172	54	44	-10
2G5Z3:04006:09709	INITIAL_QUERY	CCCTGGCGATAGTGGTCTTTCCTTTGATGCTGAGACTGCCAAGGCACACAGGGGATAGGCATTGGTCTCAACTCCTCTGCCATCTTCGCTTCAACAATCTCAGTTAGTATCTGGTTGTCATTCTTGTGCTCTGCTTCTTCTTGCTTTTCGACCACCATATCCATGGGTTCCTCATCTGGCTGTTTCA	403	414	146	157	11
2G5Z3:04476:01843	INITIAL_QUERY	CAACGACCGCCCGCTTCCCCCCTCTTCCAACTCTTATTGTTGGGGCCTGTGGGAACATTCTCGATCTTCCTCATCACTAGAAGTCCGTCAATGATTTTTCCAAACACTACATGCTTTCCATCCAGCCAATCACACTTAGAACACGTGATAAAGAACTGAGCTCCTCCGATTAGGTGTATTAATAGGTGTCCTGCAGTAATGTTAGCGTAAGCCGGACTGTCTAATGCCATTGGTTGAATAAATAGGCTAATTGTTTCAATAATAATAAGTATTGGAATTAGTGAAATTGGAGTTCCTTTGTGGAAGGAAGTGGGAAGTGAGCTTTTTAGTTTAGTGCATCGGAAGA	183	193	187	177	-10
2S43D:00752:08087	INITIAL_QUERY	CCGAGGGCCAACACCCTTTTGCCCCAGGACTGGCGGCCTGAACAATGGTTGAAGTCAGGGACCCATAGAGTTGTACCTCCACTTCCAGGGCCAGCACGCACTCCAGTGCCCGAGGACTATGACCACCTATCGGCCTCTTCCTAATGATGGTGTGGACCTGGCAGCCAGCTGGTGGGGCCAGGGTCGCTGCCAAAGAGAAATAACACATAGGACACACAATAAATCATTCAAATGATTAAGATAACTGAAGCTAAGAGTTGACTTCGACCAAATTTACAGTCTTCATTCAAGAAGAAGTTCCCAGGATGCTGAGGGGCGAGGCGGCCATTTTCCACCATGATATTCGGCAAGCAGGCATCGCCATGGGTCACGACGAGATCATCGCCGTCGGGCATGCGCGCCTTGAGCCTGGCGAACAGTTCA	511	521	412	402	-10
2G5Z3:01971:01428	INITIAL_QUERY	GCCTGCTGGTGGTCGACCGGAGACCGACGAGTCGTCTCAAGAAGCTGGCGTCTCGATCCGGGAAGAGCTGGCTGCGCCCCCCAGGAGAAGTCCGAAACAAGCCGAGCCTCCAGCGGCCGCCGGA	404	414	6	-4	-10
2S43D:08581:03746	INITIAL_QUERY	GGACTGGCTGCTATTGGGCGAAGTGCCGGGGCAGGATCTCCTGTCATCTCACCTTGCTCCTGCCGAGAAAGTATCCATCATGGCTGATGCAATGCGGCGGATGATATTGTGTCAGCAGACGTGGAAGAGGTTGAGGTGGTGGAAGGCGTGGCTGGAGAGGAGGATCATCATGATGAACAGGAAGAGCACGGGACCCCTCCCCTTTTTTTTTTAATTTGGATACTGTCTCTGTGTCCTTTAGTTAGTTTGGCTAAGGGTTTATCTAACTTATTAATTCCTCAAAGAACCAGATCTTTGTTTTGTTAATTCTTTGAATTGTTCA	273	373	0	100	100
2G5Z3:00153:08702	INITIAL_QUERY	GGCAGCAATAAGGGAAATGGGGTAATGGCCCAAAAAATAATGGTATGTGTGTGTATGGAAAGAAGGGGGTGCAAAAGCCAAAGGGAACGGTGGGGGGAAGGGACAGATGAGGTCAGGTACTGGGACGCCGCAGGTGAGAGGCCATTTCATAACAATTCTGCAAGACCTGACCTCGTTCACCTGGGAAACCCAGATTATATTACGGGAAAGTAAACTTCTCCAAGCGGTGGCAACAGTTTCAACATAATTTGGACAGCATGCGGATGCTTCCAGCAGGCGCACTATGAAATCCGGAGAAACGACGACAGGACTGTGAGCACTACAGGAAGAAACTCGAG	267	277	94	104	10
2G5Z3:05309:08789	INITIAL_QUERY	CAACGCGCATGCCCGACGGCGATGATCTCGTCGTGACCCATGCGATGCCTGCTTGCCGAATATCATGGTGGAAAATGGCCGCTTTTCTGGATTCATCGACTGTGGCCGGCTGGGTGTGGCGGACCGCA	572	648	41	117	76
2G5Z3:06719:09519	INITIAL_QUERY	CGCTCGTGCTCCACCTCCCCGGCGCGGCGGGCGAGACGGGCCGGTGGTGGCGCCCTCGGCGGACGTGGAGAGGCCTCGGGATCCTGATCATCAAGCCTCACGAGCCACGAGAGCACAGGAAGAAGGCAAGAAGAACCCCACCCGCCCCATCATCTCCAAGACCCCCTCGTGATGTGGAGGAAGAGCCACCTGCAAGATGGACGCGAGCCACAAGCTGCAACTGGTGAAACCCGGGCACGTCCGAACCCGGATGCCCAACCGGCCCGCCGGGACTGTCCGAGA	52	62	64	74	10
2S43D:06176:04467	INITIAL_QUERY	CTCGTCTCGTGCTCATGGCCAGGAGCTTGGATCCATACACTCCTGTTCCCCTTCATCAGCTGCACATCGTGTCAACAGCCGGGTGCGTAAGCAAGCTGAACATTTTGAAACTGGCTCCTGGTGGGCATGTGGGCCGTTTCTGCATCTGGACGGAGAGTGCTTTCCGGAAGTTGGATGAGCTGTATGGCACTTGGCGGAAGGCTGCTTCCCTCAAGAGTAACTACTAACCTGCCCATGCACAAGATGATGAACACCGACCTTAGCAGAATCTTGAAAAACCCGTAAATGTCTCTGAACAGCATGGGACACAGCAACAAACTGGATTCTTGTTCCTCTGTCAACCTCACTTGAGCCCTGGCCAA	394	404	226	236	10
2G5Z3:09082:03536	INITIAL_QUERY	GGAAATCCTTGAGTACTGTCCAAGGGAGATCATCAGCCTCATGGAGCGGTGCTGGCAGGGCGATCCCAGAAGACAGGCCAACATTTCTTGGCATTGAAGAAGAATTAGGCCTTTTTACTTAAGTCATTTTGAAGAATATGTAGAAAGAGGAAATGCCTATCCGACGAGACTGGAGGAAGACCCGGAAACTTCCGGGGCCACGTGGAGGCCACGGCCACGGCCGCATCGGTAAGCACCGCAAGCACCCAAGCGGCCGCGGGAATGCTGGAA	41	51	246	236	-10
2S43D:03232:08414	INITIAL_QUERY	GTCCGCTCCTGTCTCTTTGCTTTGAGTTCTCTGTGCTGCCCAAGCAACAACGAGTCGGCATGTATTAGCTCTAGAATTACCACAGTTATCCAAGTAGGAGAGGAGCGAGCGACCAAAGGAACCATAACTGATTTAATGAGCCATTCGCAGTTTCACATGCATTAAGATGTTGCTGGGGACTTGCGGACTCCGCCAGCCATATTTTATACTTGGGGAACGGTTGCCGGTACTAGCAGGAGGCGGCTGCAGCAGCAGCAGCTGCAGACGTGGACCCATTGTCTGTGTTGATATGAACACCAAGCAAATCTTTTGCGCCAAGATCTGATGAGACGCCAGGAAGAATTAAGGCGCATGGAGGAACTTCACAGTCAAGAAATGCAGAAACGTAAAGAAATGCAGTTGAGGCAAGAGGAGGAACGGCGTAGACGAGAGA	368	378	238	248	10
2G5Z3:08893:10239	INITIAL_QUERY	TCATGGTGCCCCGCCTGCCTGGCATAGCGATGGGTGTGCGGCCATTGACATCAGGAGACCCGGGGTCAGCCCCATACACTACCAGCAGCTCAGCTGCAGTGTCTGCCCTGCTGCAGCCACATGTAGAGTGTA	5	15	38	48	10
2S43D:08825:12035	INITIAL_QUERY	ATGTTAGTAGATTTCCAGTTTACTCATTTATAAGGAAACTTTCCAAATCCAATGAGCAAAACGTGTCACATATACAGTATGGATTTTAGAACACATGATGATGGATAAATTGCCTTGTCATTTTATAAAATATCTTTGACATTGTTTTTAATTACTTTCTATATCCCCTCCATGATGCTAGTTTTACTGTCTTTTACTACGATATGAACTGATAAGA	344	354	97	87	-10
2G5Z3:06891:11617	INITIAL_QUERY	GCCGTACCCTGACAGCAGTGCACGACGCCATCCTTAGGACTTAGTCTTCCCCAAGTGAAATTGTGGGTAAGAGGATCCGTGTGAAACTGGATGGCAGCCGGCTCATAAAAGTTCACTTAGACAAAGCACAAGGATATTGATTCAGTCAAGTACTTGGAATGTTCTGCACTCACCCAGCGAGGCCTGAAGACCGTCTTCGATGAGGCAATCCGCGCAGTCCTCTGCCACAGCCACACGCAGCAGAAGCGCCCTGCAGCCTGCTCTAGGGTGTCACCCGTCCCTCCCCAGGCTGTAGGAGCAAGGCATAGCCGACGGCAAAAGCATCCACAGATGCTAGCCCCACCCTGGGGAAAGGGAGCCAGAAGCGACAATACGTTCCTTTTGATAGTCTTGGCATTTGCAGAGTGGACCCAGCAGTGCCACAGTTATGCGCTGAGCCCGGCCTGACACCCAAGGCTGTTAAGGAGGATCTATGTTCCGGAGATAAGACTCAGAGTGCCGCCACCTGGCTACACACCCAAACACACATAGAGGACTCTGGAGCCGCAGTGGGACAGCCCTGCCTGCTTGTTCTTCTGAACTTGGGGACCATGCCTCTTTGGGCTCTGCTTCCAGGATGGTTTGGGAAGCATAGCAGGGCACGGCTCGGCTCCTGAGATCCATCCCCCTAGACTGACTGACCGACA	576	586	560	570	10
2G5Z3:06891:11617	INITIAL_QUERY	GCCGTACCCTGACAGCAGTGCACGACGCCATCCTTAGGACTTAGTCTTCCCCAAGTGAAATTGTGGGTAAGAGGATCCGTGTGAAACTGGATGGCAGCCGGCTCATAAAAGTTCACTTAGACAAAGCACAAGGATATTGATTCAGTCAAGTACTTGGAATGTTCTGCACTCACCCAGCGAGGCCTGAAGACCGTCTTCGATGAGGCAATCCGCGCAGTCCTCTGCCACAGCCACACGCAGCAGAAGCGCCCTGCAGCCTGCTCTAGGGTGTCACCCGTCCCTCCCCAGGCTGTAGGAGCAAGGCATAGCCGACGGCAAAAGCATCCACAGATGCTAGCCCCACCCTGGGGAAAGGGAGCCAGAAGCGACAATACGTTCCTTTTGATAGTCTTGGCATTTGCAGAGTGGACCCAGCAGTGCCACAGTTATGCGCTGAGCCCGGCCTGACACCCAAGGCTGTTAAGGAGGATCTATGTTCCGGAGATAAGACTCAGAGTGCCGCCACCTGGCTACACACCCAAACACACATAGAGGACTCTGGAGCCGCAGTGGGACAGCCCTGCCTGCTTGTTCTTCTGAACTTGGGGACCATGCCTCTTTGGGCTCTGCTTCCAGGATGGTTTGGGAAGCATAGCAGGGCACGGCTCGGCTCCTGAGATCCATCCCCCTAGACTGACTGACCGACA	324	334	293	283	-10
2G5Z3:08646:04657	INITIAL_QUERY	CAAGACCGGCCCGACAGAGACATGCTCGTTGGCCACACATCACCTATGTCCACCAGCACAGCCGCAGCCCCCTGCCCAATTTGACCTTAACACACAAATAGTTATCAGAAGAAGGGGGCCTTAATTGAGAAAATACCTCCATTAAGATCTATATGTAAGGCATTTTCTTAATTTAGTGATTAATGAGA	454	464	0	-10	-10
2G5Z3:02719:13780	INITIAL_QUERY	TCGGCGCTGGGCTCTTCCCTGTTCACTCGCCGTTACTGAGGGAATCCTGGTTAGTTTCTTTTCCTCCGCTGACTAATATGCTTAAATTCAGCGGGTCGCCACAATCAGACGTCCCCGCCAACTACAAGGTCATAAAGTCCAGCAGTGACGCCCAGCTGTCCCGAAACTCCAGTGACACGTGCCTGAGGAACCCGCTCCACAAACAGCAGTCTCTCCCTCTCCACAGCTGACGGATACCCAGATCAAAAGAAGCACCTCTTGTAATCAGAGAGGGTGCGGCCATCTTCCAGCTGCTTGCCGGCAAGATCAGCCTCTGCTGGTCAGGGGGATGCCGGTCCTTTATTCCTCGGATCTTGGCCTTCACGTTCTCGATGGTGTCACACCCACACCAGGCTCCTGAGGACAAGGCTGTCCACCTGACTGATGACAGTGCACAGTAGTGATGGTGTGCTCCGGGTGTGCTGCCCAGTGCTCAGTCCACCTTTTCCACCATTCCGTACTTGCCGGCTAGCCGCATACCCGCGGGGCTGGAGAACCGGCTGTGTGCGGCCACAGCCACCATCCTGGACAAACCCGAAGACCGCGTGAGCGTTACGATACGACCTGGATTCTCTTGCTGGTAAAATCACTGGCATGCTGTTGGAGATTGATAACTCAGAATTACTTCACATGCTCGAGTCTCCAGAGTCTCTCCGCTCAAAGGTTGATGAAGCTGTAGCTGTACTACAAGCCCACCAAGCGAAAGAGGCTGCCCAGAAAGCAGTGAACAGTGCCACTGGTGTTCCAACTGTCTAAATTGATCAGA	408	421	731	744	13
2G5Z3:02719:13780	INITIAL_QUERY	TCGGCGCTGGGCTCTTCCCTGTTCACTCGCCGTTACTGAGGGAATCCTGGTTAGTTTCTTTTCCTCCGCTGACTAATATGCTTAAATTCAGCGGGTCGCCACAATCAGACGTCCCCGCCAACTACAAGGTCATAAAGTCCAGCAGTGACGCCCAGCTGTCCCGAAACTCCAGTGACACGTGCCTGAGGAACCCGCTCCACAAACAGCAGTCTCTCCCTCTCCACAGCTGACGGATACCCAGATCAAAAGAAGCACCTCTTGTAATCAGAGAGGGTGCGGCCATCTTCCAGCTGCTTGCCGGCAAGATCAGCCTCTGCTGGTCAGGGGGATGCCGGTCCTTTATTCCTCGGATCTTGGCCTTCACGTTCTCGATGGTGTCACACCCACACCAGGCTCCTGAGGACAAGGCTGTCCACCTGACTGATGACAGTGCACAGTAGTGATGGTGTGCTCCGGGTGTGCTGCCCAGTGCTCAGTCCACCTTTTCCACCATTCCGTACTTGCCGGCTAGCCGCATACCCGCGGGGCTGGAGAACCGGCTGTGTGCGGCCACAGCCACCATCCTGGACAAACCCGAAGACCGCGTGAGCGTTACGATACGACCTGGATTCTCTTGCTGGTAAAATCACTGGCATGCTGTTGGAGATTGATAACTCAGAATTACTTCACATGCTCGAGTCTCCAGAGTCTCTCCGCTCAAAGGTTGATGAAGCTGTAGCTGTACTACAAGCCCACCAAGCGAAAGAGGCTGCCCAGAAAGCAGTGAACAGTGCCACTGGTGTTCCAACTGTCTAAATTGATCAGA	595	605	483	473	-10
2S43D:06765:02649	INITIAL_QUERY	CTGCAGTAGGTTAGTATGTCCCCTGCCTTAAACCTCAGCACCATGTGCCTTGCAAGAAACCTCGCCTCTCATAGACCACAGCTACCTACTTCCCCTTAAAGGATGTAGTTTTCCATGAACGAGAAGACTAGAGTTGGGTATTAATGTCCTGTATATCCTTAGGTTCGTTATATTGATCAATGACCAGATAAAAAATCAAAACTGGCTGGCCAGGCAGCCGCGGCGGAGATAAGGATAGAAATGAGAGGACGCCAAATCGCAGCTTGCAGCACCGGA	211	221	202	212	10
2G5Z3:03456:05471	INITIAL_QUERY	GGCTACTCTCCCCTCACTGTTCATCTCTGGGCTCAGTGACTTTTGTTCCCACTACCTGGCTGATGGGCCTGTCATCTTCCTGGACTCTGCATCCATTGGACATTTACTGTGGCCTTTGGCTAGCCTGCGGATCTTGGTCAGCTCTGTCATTCCAT	312	322	67	77	10
2S43D:06196:08517	INITIAL_QUERY	GAACAGTACATGTTATGACCAAAGAGCCCTTTCCAGTGTGGCCCCCAGTCCTGGGCCTGTGTCAGTGCTCTAGGCCACCACAAGCACTAGTCACAGACACCGTTACCCCGTCGTCGCGGCCATCCACATTGCAGCCCACAGACTGTGCAGTACCCAGGATCTCCTTGATAGTTCCAGAAAGTTCTCTAGCCAAAGACCGGTGTCTCATCTGCCGGGCAATGTTGACAATCTCATCAAAAGTAATA	304	315	154	165	11
2S43D:00896:02153	INITIAL_QUERY	CTGACCGGCGTACCCTCATGAAGTACAGCCAGCATAGCCACAAGGTACGCAAATAACTGTTTGGTATTTTGATGCAGATGAGCGAGCGAGAGACTAAGTAAAAATATCTAACAGGTGAGAAAGGTGTGAGGGCTTGACTTCGCAAAAGTGGAGTAGGCAACATATTCATTAAAAATTTGGACAAATCCATCGACAATAAAGCACTATATGATACGTTTTCTGCGTTTGGTAACATCCTTTCATGTAAGGTGGTTTGTGATGAAAATGGACTCCAAGGGCTATGGATTTGTACACTTTGAAACAGCCCAAAGGTGAGATTTTATAGCATAGCTTTGGGAACAAAGTGGAACTGATACATATAGACGTAGCATACATACACAGGCATGTACTCAGGAATGCATAAACACACATGTGTGTGCACACATACAAACATCAGCGGTTAGGAGCAAGCACTAGCAATTGCTGCTGTAGCAGAGGATCTGGCTTGGGTTCCAAGCACCTTCTTGTGGCTAACAATTGTCTGTAAACTCTAGTCACTGGGGTTCTACTACTCTCTGGCCTCTATCTTGGGCTACACTGAGGACCAGGTTGTCTCCTGCGACTTCAACAGCAACTCCCACTCTTCCACCTTCGATGCGGGGCAGGATCCAAATCCCCCTGAAAATTCACACAAGGGCG	299	311	636	648	12
2S43D:00896:02153	INITIAL_QUERY	CTGACCGGCGTACCCTCATGAAGTACAGCCAGCATAGCCACAAGGTACGCAAATAACTGTTTGGTATTTTGATGCAGATGAGCGAGCGAGAGACTAAGTAAAAATATCTAACAGGTGAGAAAGGTGTGAGGGCTTGACTTCGCAAAAGTGGAGTAGGCAACATATTCATTAAAAATTTGGACAAATCCATCGACAATAAAGCACTATATGATACGTTTTCTGCGTTTGGTAACATCCTTTCATGTAAGGTGGTTTGTGATGAAAATGGACTCCAAGGGCTATGGATTTGTACACTTTGAAACAGCCCAAAGGTGAGATTTTATAGCATAGCTTTGGGAACAAAGTGGAACTGATACATATAGACGTAGCATACATACACAGGCATGTACTCAGGAATGCATAAACACACATGTGTGTGCACACATACAAACATCAGCGGTTAGGAGCAAGCACTAGCAATTGCTGCTGTAGCAGAGGATCTGGCTTGGGTTCCAAGCACCTTCTTGTGGCTAACAATTGTCTGTAAACTCTAGTCACTGGGGTTCTACTACTCTCTGGCCTCTATCTTGGGCTACACTGAGGACCAGGTTGTCTCCTGCGACTTCAACAGCAACTCCCACTCTTCCACCTTCGATGCGGGGCAGGATCCAAATCCCCCTGAAAATTCACACAAGGGCG	318	328	308	298	-10
2S43D:08236:06853	INITIAL_QUERY	TTTATCCTAGCACTCTGGAGGCAGAGACTGGTTAGTGGGTCTCTGAGAGGTGGTGGCCAGTCTGGTTAACATAGTGACACCCTGCCTTAAAAACAAAAAGCAAAACAAAACAAAAAGAAAAGGGGGGGA	143	153	109	99	-10
2G5Z3:09160:11039	INITIAL_QUERY	AGAAAACTAAGCATTGTATTTTTTTAACAAATCTGAGAAAGCACTATGAACTGCAGGTGTTTGACTTTCAGAATATATTTTGTATTGTTAATACTCACATTATGTGAATACTGGACGCTGCAGATCTTTGTAGGCCGCAGTCCAGTTGAGCTTGTCCAGGCTGTCACCATCTTGAGCCCAGTCCACCACATACTCCAACGGTTTCCTGGTCCCTTGTTTCCAGGTCACCTTTATCCCTGGGCTCCCATCAGCACTGCTCACTCCACGTCACAGGGTCGGAGTGCTGTCAGGCCTGTGCTATGCCCTGCTCTACCCTGGCCTGTCAGGTGCTTTCACCTACCTGGTGGGGGTCTATGTGGCCCTCATCAGCTTCATGGGCTGGAGAGCTATGGCAGGGCTGCGGTTGGTTGGGGCAGCCTGGCGGTGGACAGAGCTGGCGGCCGGCGGTGGTGCTCTGCTCTTCATCCTCTCGGACCTGACCATCGAAGTCTTTGAGCCGCCTGCGGACATGGTCCGGGAGCGAGCCTGCCGGGGAGGCAAGCGCAGGCACTCGGCGTGGAGCTGTTCGCGCTGGCATCTTGCAGGTTGCAGACGACAGAACAGCTCTGAACGAGATCATGCCCAGCCTCTATCAGCAGCAGCCGCAGACC	179	191	45	57	12
2G5Z3:09160:11039	INITIAL_QUERY	AGAAAACTAAGCATTGTATTTTTTTAACAAATCTGAGAAAGCACTATGAACTGCAGGTGTTTGACTTTCAGAATATATTTTGTATTGTTAATACTCACATTATGTGAATACTGGACGCTGCAGATCTTTGTAGGCCGCAGTCCAGTTGAGCTTGTCCAGGCTGTCACCATCTTGAGCCCAGTCCACCACATACTCCAACGGTTTCCTGGTCCCTTGTTTCCAGGTCACCTTTATCCCTGGGCTCCCATCAGCACTGCTCACTCCACGTCACAGGGTCGGAGTGCTGTCAGGCCTGTGCTATGCCCTGCTCTACCCTGGCCTGTCAGGTGCTTTCACCTACCTGGTGGGGGTCTATGTGGCCCTCATCAGCTTCATGGGCTGGAGAGCTATGGCAGGGCTGCGGTTGGTTGGGGCAGCCTGGCGGTGGACAGAGCTGGCGGCCGGCGGTGGTGCTCTGCTCTTCATCCTCTCGGACCTGACCATCGAAGTCTTTGAGCCGCCTGCGGACATGGTCCGGGAGCGAGCCTGCCGGGGAGGCAAGCGCAGGCACTCGGCGTGGAGCTGTTCGCGCTGGCATCTTGCAGGTTGCAGACGACAGAACAGCTCTGAACGAGATCATGCCCAGCCTCTATCAGCAGCAGCCGCAGACC	551	561	609	599	-10
2G5Z3:01732:03783	INITIAL_QUERY	CCTCCCCTTTTCCTTTTCCTTCCTTTCCTTCTCCATTTAATATGGTTGTATATTAGTTGGTTTTTCCCAGAGTTGGGCTGGCAGGTGTCCCACTTTTCTATGTAGTGTAATTAGGAAATAAATCCAAGCACTAAGCTGGAGTCCCAAGACAAAAAAACTGAAACATGGACCCGGCTGGAGCCCCAGCTGAAGACAGATGGGCTGACTCCTGTTGAGATGCAGAACCTGGAACCTGGCACCTGCTACCAGGTGTCTGGCCGCTGCCAGGTGGAGAACGGACGGGGGGTCAAAACAGTGCAGCAGCAGTGGACAGGTCAGGTTGGGTCGGGCAGCGCAGGGGACAGAAGCGGTAGGCAGGAGCCAGAGCCCTGGGGCCTCCCTTAGCAGTAAACAATTCTGTCCTCTTTAGGAGCATGCTTTAGTGACACAGAAAACTACTGCGACAGGAGGCGGCATAACGATGGAAGTGTTCAGAGGAATCACGTAGCACTTGTCCAGGTTAAGGTCCAAATAAGCAGTGAGTTTCTTGTTGAAGTCGTGCACAATGTTGGCAGGATCGCTGTCCGCAAACTCTGGTACAGGCACACTGATGAATTCACTTGATGAAACTGCTGCCAAAGCCAAGGAAGTTCTGTTAAAAATCCTGAGACTCTCCATTCCTCATCCTTAGGAAGGTTTAGACAACTGGAGTCTTCTCCCACCCTGTACCCCATGTGTACCCCAGTTGACTACACCCCTCTCCCC	125	136	329	340	11
2G5Z3:09327:11078	INITIAL_QUERY	GAGATACAGAAGAGATGACGACAGAAGTAAACACTTACCAGAGCAAAAATTGGAAAACCAGCATCCAGAAAGTTAATCAAAGTTGAAAGACGGCTTTGCCCATGCCTATCTGAAAACAGACCTTTCATACTGCACATAGAGACTGGGAGGGGGAAAAATGAGCGGACTTGGGACTGATATAGGAACCCTCTCCACATGAGTAGAACCTCGAAGGCTGGGTGTTCTCTTTAAGAGGCTCGTTCAGTTCAATACTGTGGAAACCAAGCTGGTAAGTGACAGCGTCTGCCACTGCTTGGGTATCAGCGGCTGAGCCTGAGCGGCAGCAGAAGATGTGATCGTGGATAGGGGTCACTTGTCAGTCACTCGATTGGCGTGTAGGACCAGTGA	638	648	212	222	10
2S43D:09356:12664	INITIAL_QUERY	GGTTTCCCAGGCAGCTGCAGACTGAACAGTTCTGTCTGCAGAATGCTACAACATGACCCTCTGCTGACTGGAGTGTCTTCAAGTACGAATCCCTTCAGACCCCAGAAAGTCTGCTCCTTTTTGTAGTCAAGAGGAAGAACGAGCCCCTGACCATCAGTACTACAATGACTTTCCAGGGAAGGAACCCCCTCTTGGTGGGGTGGTAGATATGAGGCTTCGGGAAGGGGCTGCTCGACCCACTCTGCCTAGTGCCCAGATGTCCAGCCACTTGGGAGCTACACTGCCTATACGGTCAGCATGCGTGGCCAGGAGACCGTAAATGTATGTGGTAAAAGGCCTAGGAGATTTGTTGATCAATAAATATGATTAGGGAAACAATTATTAGGGTTCATGTTCGTCTTTTGGTGTGTGGTTAGCATTATTTGTTTGATAATAATGTTT	492	502	140	130	-10
2G5Z3:08481:03758	INITIAL_QUERY	AGAGAATCATAATTCTACAGGAATTTCACAGTGGTGGTTTGCCACGCACTCTGGTGGAGTCAGCTTGACAGGCGAAAGCTTGGAAGCTATCTCATGAGGAAGAGTTTCACGAAAGCTCCCTCCTGGAGTCTGATCGTCCTTCCCTACTCTATTAGTAGAAGTGTTCTCATAGCTCATTTCCTCTGACAGCATCGTTTTGGTTTAGTTTCTTAGGGCAGCTAGAAAGCAGATAATCACCTGCCTGACATTGCTCATGCTCAGAGTGACGGGGTTGATAGTACAAGTCAGACAGACTCGAGATCTGACCATCTAGGTCACCTGAATCCAGAGGACACAATTAAGAGCCAAAACATCTAGGCCACAAGAGAGTGGGAAAGCCGTGCAGGACCCCAAACAGCCAGGCAGAGCCACACGGTCAAGGGCCTCACACACAAAAGACCAGCCCACGTGACCGTCACACGGCACAGGCAAGAGTCAGAAATACCATCCAATAGAGTCTAGGGAGTGAAGGTGCCTTCCAAACAGAGTTGGGTGACCATTCCCCGGGAACAGTTCACCATGGCTGACAAACTCCTCATCTGGGGACACAAAAGGACGGCCTCTGTGGTCCTCTGTCTCTGTGAACCTGGAGACCCAAATGAAGCCAGACACACCCCAGATCTTCTCTCAAGTGGATTATTTCTGAGAAAGACTCTATTACAGAGAATCTGTTTGGGGAAATGCTGTCAAGGGTAAACCACAACATATACTGCTTTATAAATACTCCAGAGAGAGTTTATAAGTTGAAAGTATTTCCCAGTTACCAATAATAGCTGAAATGATAAGATTTCTTTTGTTGTGCCA	616	626	319	309	-10
2G5Z3:07395:14180	INITIAL_QUERY	GTCCAAAGCCGATTGTATTTGTATTGCACACGTTCTTATCCGCCAAAGTCACTCGCATGGGACTGCTTGTGTGAGCAGCAAGAGTGAAAGAAAGAGCTTTGACTGTCACAAGAAGTATTTCCACCTCAAAAGATGAAAAGAAAGAAAAAGCAACAACAAAGAAGCACAAACAGAAGAGCCTGGCGAAAAGAAGGCTGCTAAGACCTGTTTATAGAGCACAACAGGGTGACAGACAAACTGTAATAATCAAGGCCAGTGTCACTCGCTCGCCCACTAGAAAAGTTCGAGTCTTCAAGTGAGTGTCCAGCAGCCCCATGATCAGTCTATGAGTCAATATAATGCAACAGGGTGTTTTGAGACCTTTGTTTTCACCTCTTGGCTATATCTATTTTTAAAAGGCTTGAAATTTTTATCCCTTTTACACAATTTTTCAATTTTTTCTTTTCAAAGTCTTCTGTTATAGTTGGCTATTGCAGAGTGTATATTGTCTTATCATTCCAGA	88	98	6	-4	-10
2G5Z3:02620:14342	INITIAL_QUERY	GGCTTGCGAAGAGCTAGGACGCAGAGTGCGGCGCAGCTTTGCTCACACACCTGGGGGCTGGCCAGGTGCCGAGTCATAGCAGCCACAATGGACTCCGTACCACCTGCCCGGACAATGGCATCCTTTACGTCGTCGTTTGCCTGCGATAGCCCTCAGGGCACCTGAGAACTTGCACGGTTATGGACCACGACTGGCTGTCCACCAATGACTTTGCTGGGGAAGCAGCCCTTGGTCTGGGTGGCAGTCAGTGGCATCGCAAGG	169	179	152	142	-10
2G5Z3:07060:09045	INITIAL_QUERY	CCCTCCTCTTCTTCACTAACATAAGCCCAGGGCCTAATTCTTATAACAAAAAGAAAGTTGAAGGAAGCAGAAGTTTCTCTGCCAGGGCTTTCTTGCTCAGGGGTGGGAGTGAGTTCATACACAATGAGAATATGCTAAATTATTCCATTTCGTTTCGAAATCATGTTTCTAAATTCTTTACCATCAGAAAGAAAAGGAGTGTCATACACTTTCAAGGGAAGGCTTGGTCTGCGTTTTCTGTGTTTGGATTATTTTTATACTTTGCTGATCTTTAAGCTATCCATGGGAATGTGGGACAGCTCTGTGTAGGGGATTCGGGGATTCAGCTCACACTCCATCAGCGTCGCTCCTTCATAGTCCTTGATGTAGCCCAGATAGCGGCTCTTGGGCACCTTTGATGTCTTTGGAGAGCCTGCTTTTTGAAGTAGCCAATGGCGTAACA	143	153	45	35	-10
2G5Z3:10109:07337	INITIAL_QUERY	GTGCAATCCACCTTTGCTAATGGGACTATTCCTTTTAATCTGGTTGCTGCAGCTTCATACTCAGGGGCAAGCCTCTTGCAATGTCCACACCAGGGGGCGAAGAACTCGACTAGCATGAGCCCCCGCCCGAGCCCGTGTCGGAGACGCGA	21	31	0	-10	-10
2S43D:02891:04897	INITIAL_QUERY	TTCTTATCCTCCCAGGATTTGGAATTATTTCACATGTAGTTACTTACTACTCCGGAAAAAAAGAACCTTTCGGCTATATAGGAATAGTATGAGCAATAATGTCTATTGGCTTTCTAGGCTTTATTGTATGAGCCAGAACACTGTATACCTAAATTCAACACAAGTCAAAATGGGCTGAGGAGTGGAGGAACACAAGCCTCTCACCTACCATCCTCACGATCCTCTTTCAACTGGTCCCGGATCTTCTGGCTTGAGGGCCTTGAGTCTCCGTACGGAAGCATCCCATCATGAAGTGTGATGTGGATATCCGGCAAAGACTGTATGCCAATACAGTGCTGTCTGGTGGTACACCATGTACCCAGGCATTGCCTTGACAGGATGGCAGAACAGGAAGGATCACAGCCCATACCGCAACGTAGCAACCGAATGGAAGCTT	141	151	57	47	-10
2S43D:04051:10475	INITIAL_QUERY	CATCAAGGATGGCAAACTGATCAAGAACAATGCATCTACTGACTATGACTTGTCTGACAAGAGCATCAACCCACTGGGTGGCTTTGTGCATTATGGTGAGGTGACCAATGACTTCATCATGCTCAAAGGCTGTGTGGTGGGGACCAAGAAGCA	485	495	58	68	10
2S43D:01841:14012	INITIAL_QUERY	GGACTGGGAGAGAGTCTCCAACATGACCACGCATGATCTGTTTTGACACACTCAATGATGGATGCGGAATGCAGCAATAGTGTTGCCCGCTCAGTTCTTGAAAGCCAGATGTTCCAAAAAGTAGCCTGCTCCATTGTTCTTCTCAGTCTCATAGCGACTGCCAGCGTCAATCCACACTCCCACCGTGCAGGTAGCATGCGAGGACTTGCTCCGAGGCCACACGCAGCCCGTTGTCCCAAGGAGCTGACCTGACCACCAGGCTGCCTCTGCTGTGACCTCCTAGGACATGCATTGGAACCTGCTTGCTTGCCTCTCGAGCCTGATCCAGGGCACTGAGGCATGTCAGGTGGAGCAGCTGGTGGGCCATGCGTGAGTGCTGGCGCCAGAACAGCAGGGGACGCCCTCCTGCAGATGATCACCATCCACTTACCATCCCCCGTCACTGCACAGAAGTACCGTTGTGAGCTGCTATACGAGGGGCCTCCCCGACGATGGAGGCCGCCATGGGTATTAAGAGCTGCGACCCCAAAGGCCGA	565	575	499	489	-10
2G5Z3:06681:12437	INITIAL_QUERY	GTGGCGGGTCAGGCTGCGGAGCTCGTGGATGCCATGCGCGAACTGGCACTTGTCCCCCGTACTTACAGGGCACCGTTTTTCTTCGAAGGGACGGCACAGCTCCGTCTTGTAGCGGCTGGAGGAAAAAGGCCGAAGATGATTTGAATGAAGATGCTGAGAAAAGTGCCAGCAGCCCCAGCCCTTATGTGATGGTGTTATCCAGTTCAAACGGGTTTCTCCAGTGGCCCGCTCCCATTCCTCGCCACCGTTCCCCAGCTGGGGGAAGTGCTTACTGGTGCAAAGCTGGCAGAGGCCGGTAGCGTA	168	178	65	55	-10
2G5Z3:07568:02250	INITIAL_QUERY	GTAAGAGGCTAATAATGAAGGAGAATTTGATTGATGTGGTGGTGTACAGTGGGAAGTTGATGTGTTTAATTAGGTTTGATATTGAAATTAGGATTGAGCGGGGAGCATTTTTGAGCAATTTATTAACATGTGTTCCAAACCTGTCAAATCCTGCAAGCTTAAAGGTAGGTCGTGAATTCTCGTGGCCAGTGTTCGGATTTCCCTATCAGACAAGACACCAGATTGGTCTGTGTCTACTTCATGAAAGACA	214	224	179	169	-10
2G5Z3:06538:04088	INITIAL_QUERY	GAGAAAACAGAAGGATATCTATCATCATCAATGCTTCTGCTCCACCCTACACTGTACAGAATGAACTGAAGCCCCGAACAAATAGAGCAGCTCAAGCTGATCATGAGCAAAACGATATGATGGCAACCAACAAGCACTTGACCTCAAGGGCACCACCAGTGGTACACTGTGCTTGATTTAAAGGATGCCTTTTTCTGCCTGAGACTCACCGGGTCTCTTCAGGCTGATCTTAAGCTTTTAATCCTCTTGCCAGAGCCTCCTTGTGCTGGCATAAAACACTTTATGTTATCTGGGATTGAACTCAGAATCTTGTACATGATAAGCCAGTACACTGAGCACACCCACGCTCCTCACTGGGGGATTCTAGGCAGGGGCTCTACACTGACCACACCCCAGCAAGC	177	187	58	68	10
2S43D:06355:09181	INITIAL_QUERY	GGCTTCTCTTGGGTCCGTGGACTCAAACTTGCGGGTGTAGAGCATGAGCAGACGCACAAAGTTCAGCCGTCGCATGCAGGGAGGGTCGCCAGGCTCGTGGCTGAGGAGTTGAGCACTCTGTCAGAGGACTTTAAAAGCAAGCTTTAGCTCAAACAGCACCAGGGCCACATGGACAGCATGGCAGCGCAGCCGCTCCATGACGGAAGAGAACGGCAATGA	518	529	85	96	11
2G5Z3:04841:05671	INITIAL_QUERY	CTGCAGTTCAATGACATACCAGTGTGTCTCAGGCCCACACGGCTGGGCCCCGAAGCTAGGCGCTTATAGCCTGGTTCTACTCCTCCTTAAAGTCGCTTCTACTCAATGAAGCAGTGGAGCAAAAGGAACCTGGTGGAAACCTTGCTCATCAGCTGGGGAAATTTGGCACTCGGATGTCCAAGGGCTTGGGAGCAGAAAGTTGGTGATGACAACTTGAAATTATGAGGTTTTAGGGTTCGTACATGGTTTGGATTAAGATAGTAGGGCAATGGACTCTGGCTACTTCCTGGAGGTGAAGTCACACTGACCACATCTGAGACACCCTCCTACCCCCAATCATGCCAGTCAGTTCGTCCCCAGTAAGTCTCAGGACTGACCACCACAGGCTTTACAGGAAAGTCACCTGAGTGCTGACCTCGATTCCTTGTTCACAAACCGCTCATGCCACCCATACTTTTCTTCTGTTTCTGTACCTGGATCAGTCCCATCACCACCTCAGCACTCATCAGCTTCATATCCATCATTCCATCTGTTTATTCTGCATTAAAGACATGCAGAGTTTGAGGCTGTAAGCAGCATTCCTGGGAACATCATTAGATTCCAGGTAATAGTCTTCTACAAACAACACCAGTCTC	344	354	514	524	10
2G5Z3:04841:05671	INITIAL_QUERY	CTGCAGTTCAATGACATACCAGTGTGTCTCAGGCCCACACGGCTGGGCCCCGAAGCTAGGCGCTTATAGCCTGGTTCTACTCCTCCTTAAAGTCGCTTCTACTCAATGAAGCAGTGGAGCAAAAGGAACCTGGTGGAAACCTTGCTCATCAGCTGGGGAAATTTGGCACTCGGATGTCCAAGGGCTTGGGAGCAGAAAGTTGGTGATGACAACTTGAAATTATGAGGTTTTAGGGTTCGTACATGGTTTGGATTAAGATAGTAGGGCAATGGACTCTGGCTACTTCCTGGAGGTGAAGTCACACTGACCACATCTGAGACACCCTCCTACCCCCAATCATGCCAGTCAGTTCGTCCCCAGTAAGTCTCAGGACTGACCACCACAGGCTTTACAGGAAAGTCACCTGAGTGCTGACCTCGATTCCTTGTTCACAAACCGCTCATGCCACCCATACTTTTCTTCTGTTTCTGTACCTGGATCAGTCCCATCACCACCTCAGCACTCATCAGCTTCATATCCATCATTCCATCTGTTTATTCTGCATTAAAGACATGCAGAGTTTGAGGCTGTAAGCAGCATTCCTGGGAACATCATTAGATTCCAGGTAATAGTCTTCTACAAACAACACCAGTCTC	180	190	0	-10	-10
2S43D:04924:00205	INITIAL_QUERY	ACATTCTAGAGCTCTTCGGATCTATTCTCCCACTGGACTTGGAGGACATCTTTAAGAAGAGGAAGACTCGCTACCACAAGCGCACTAGCTCTGCTGTTTGGAACTCACCACCCCAGGAAACGCGGCATTCACTGCGCCATCGATGCGTCCCAGACCCCTGACATCGTGTTTGCGAGCATCCTGGCAGCCTTCTCCAAAGCCACATGTAAAGACCTGGTCATGTTTATCTAATGTTGGGTCTAAAGGCTCTCTCTCCTGTCAGGAGGGAAGAAACCAGAACTGAAACTGGGTCCTAAGGCTCGGACTTTCCCACCCTGTTAGACTGGCAAGAAGGAGTGGTAACTGGTTAGGACCCTTGCCAGCCATCCAGGAAATCCTGGAAGTCTGCTGTTGGTAATACCCTGCACAGATAGAAACGTTCCCGCCAAAGGACAATACGGACCCAGAAAAGCCGGGTGCTCCGATCCTCAGGCTTGAGGGTCTCATGCCTCACACGCTGCACCTGCCTTGAATGAGGCGGTGGATGGGAACTTGCTGTGGGTCCTTCATCTCTGCCACAAAAATCTTAGTCACAGACTGCCTCGGCTCGCTGGAACCATGTGTGGGTCGGCGACTGAGACTGCCAAGCACACAAGGGGACTAGG	309	319	251	261	10
2S43D:04924:00205	INITIAL_QUERY	ACATTCTAGAGCTCTTCGGATCTATTCTCCCACTGGACTTGGAGGACATCTTTAAGAAGAGGAAGACTCGCTACCACAAGCGCACTAGCTCTGCTGTTTGGAACTCACCACCCCAGGAAACGCGGCATTCACTGCGCCATCGATGCGTCCCAGACCCCTGACATCGTGTTTGCGAGCATCCTGGCAGCCTTCTCCAAAGCCACATGTAAAGACCTGGTCATGTTTATCTAATGTTGGGTCTAAAGGCTCTCTCTCCTGTCAGGAGGGAAGAAACCAGAACTGAAACTGGGTCCTAAGGCTCGGACTTTCCCACCCTGTTAGACTGGCAAGAAGGAGTGGTAACTGGTTAGGACCCTTGCCAGCCATCCAGGAAATCCTGGAAGTCTGCTGTTGGTAATACCCTGCACAGATAGAAACGTTCCCGCCAAAGGACAATACGGACCCAGAAAAGCCGGGTGCTCCGATCCTCAGGCTTGAGGGTCTCATGCCTCACACGCTGCACCTGCCTTGAATGAGGCGGTGGATGGGAACTTGCTGTGGGTCCTTCATCTCTGCCACAAAAATCTTAGTCACAGACTGCCTCGGCTCGCTGGAACCATGTGTGGGTCGGCGACTGAGACTGCCAAGCACACAAGGGGACTAGG	611	621	442	432	-10
2G5Z3:09898:05532	INITIAL_QUERY	CAGGCAGAGAGGTGTGGTACAGGCCTAGAGAGATGTTCTCAGGACCATGTGCAGGTACAGCAGCTTTGAGGCTAAAGGCCAGATCAAAGTTGAGGCTGAGGGGACTAGCTCCAAGGGCCTTTAAATCACTGTTCCTCTGCAGCTTGTCCCTTCCCA	267	277	145	135	-10
2S43D:05284:10264	INITIAL_QUERY	GAGCTGCTGACGAGGACTGGGACAGTGAACTGGAAGATGACTTGCTTGGAGAAGATTTACTGTCTGGCAAAAAGAACCAGTCGGATTTGTCAGATGAAGAGCTGAATGATGATCTGTTACAGAGTGATAACGAAGAGA	141	151	68	58	-10
2G5Z3:10550:08209	INITIAL_QUERY	AGCGACAGCAGTATGGAAACGGCGGGGGCCTACGGCGGGAACGCTACGGCGGGGCCGCAGAAACTGAGCCGTAAGAAGTACTTGGCCCCTCCGGAAGGAAGTTAGATACGTAAAACTTCCACTTTCACCCCTACTATACAACTCAAACGATATCCCTAGGTATCCCTAAATCAGTATTCTTAATTCTCATAACCCTAGTATTATTTTTCGTTGGTGGAGTCCACTCAAGAAATTCTGTGCTTCCACGAGCTTCCCGCCCACACCTTTCGCTGCTCTTCCCCCGATGGAAGAGGCCACCAACTGGACCGACGAAGGGCTGCCTGCTGTTTCAGTCGTGGCCATTTCTATTCAGGACTTGGATGTGAGGTACACGGCCGTGAGCAGCTTCATCTTCCTCAGGTTCTTCGCCCTGCCATCCCTGTCCCC	215	225	331	321	-10
2S43D:03737:03695	INITIAL_QUERY	GTCGAATGGGCAGGTAGCCGGATCAAGCGTATGCAGCCGCCGCATTGCATCAGCCATGATGGATACTTTCTCGGCAGGAGCAAGGTGAGATGACAGGAGATCCTGCCCCGGCACTTCGCCCAATAGCAGCCCAGTCCCTTCCCCGCTTCAGTGACAACGTCGAGCACAGACTAGGGTCACATCCAGTACCATCGTCTAGCATGGGTCCGATGACCGAGAGAAACTTTTCTCCCGAGACGTACGGGCGGCAATGCCACCACAGATATGACATGCGCTCTCCACCACCCCTCCGAAAACTACACCATCAGAAGTTTATATTCTTATCCTCCCAGGATTTGGAATTATTCACATGTAGTTACTTACTACTCCGGAAAAAAGAACCTTTCGGCTATATAGGAATAGTATGAGCAATAATGTCTATTGGCTTTCTAGGCTTTATTGTATGAGCCCACA	141	151	372	362	-10
2G5Z3:10222:02277	INITIAL_QUERY	TTCCGTATTTGCTTGTTCCACTGTTTTGTAATTCACCGCAAGGTCAGAGGTTTAGTTAAGTTCTAAGGAATGCTATAGATACCTGACTCCTGATGGGCCCAGCCGTTTCCCCGTGTGGCGGGCCCCGGGGCTCAGGGCACCAATGCGCCATTGTAGAGCC	169	179	131	121	-10
2S43D:03695:01808	INITIAL_QUERY	CATGCGATGCCTGCTTGCCGAATATCATGGTGGAAAATGGCCGCTTTTCTGGATTCATCGACTGTGGCCGGCTGGGTGTGGCGGACCGCTATCAGGACATAGCGTTGGCTACCCGTGATATTGCTGAAGAGCTTGGCGGCGAATGGGCTGACCGCTTCCTCGTGCACCAGCCCACCTGCAGGCTGGGTCCCCATACTCCTCGCCTCCTCCCAGATAAACAAGTATGTCTGCGTGTGAACATTCTGCCTTCTGCTCTCGTGCCAGATCTTCTCCATGTCGTCCCAGTTAGTGACAATGCCGTGTTCGATAGGGTACTTCAGGGTCAGGATACCCCTCTTGCTCTGGGCCTCGTCCACCCACGTATGAGTCTTTCTGGCCC	572	648	3	79	76
2G5Z3:00084:09570	INITIAL_QUERY	CAGCATCAGAGCTGAGGAGACACGGTGTCCATATCCCAAAAAAGAGAAAAACCGAAAGCGTCGGAACCGAAAGAAGAAGAAAAAGCCACAGCGGGTGCGGGCAGCCTCAGTCAGAGAGCTCGTCGGGGACCGAGAGAAGGACTCCGGTCGGTCCGCGGCTCCGGACCCCCCTGCTGCTGACGTGGAGATTGAGTGAACTGGTGA	98	108	2	-8	-10
2G5Z3:03936:03793	INITIAL_QUERY	CACACACACACACACTCCAGTGAGGGAGAAGGGGGAGGAGGGGAGTAAGGAGAACCCCTCCATAAACATGCCCCGGAAGCTGCCGGCGGGCATGGGAATAACTGCCGCCGCATCGCCAGTCGGCATCGTTTTATGGTCGGAACTACGAGTCGGCATCTGATCGTCTTCGAACCTCCGACTTTCGTTCTTGATTAATTGAAAACCATTAAGAAATGCTCCGAGAGATGGAAGACCATGTCTGCAAAAGGAAAAGTCCAAGGTTTGAAGATTTGGCCAAGAGCGACAAAGCATCGTTATGACAGGACCAGCCTCACAGTCGGTTTAGCTCCCGCTGCGTTTGTCCCCAACCATACACTCATCAGCGCTGCTCCCCCAGGGACGGACCCCATACACAGCTGGACTTGGCTGCAGCAGCGACAAC	364	374	103	93	-10
2G5Z3:00788:06412	INITIAL_QUERY	CTGATAATAGCATGCACCTGCAGTCTCAGTGTTCCTCCAGCGAGATGGGAGGCAGAGACGAGAGTGCTGGAAGCTCAGCACCGGACAGGTCGGTCTTGACAAAAAGAACCGGGCGCCCTGCGCTGCAGCCGGAACACGGCGGCATCAGAGCAGCCGATTGTCTGTTGTGCCAGTCTA	78	88	161	151	-10
2G5Z3:07591:05811	INITIAL_QUERY	TGCGCGTACATAAGAGTTACATGGAATCTTCAGGTTATTGGGAGTACAAATGGGGTACACACAATAAACCCGGCAGGGAAGCAAATGAAACCAGACTGAAACAACAACAGAGCAGGCATCTGAGGGCCCACTGAAGGGCATCTTGGGCTACACTGAGGACCAGGTTGTCTCCTGCGACTTCAACAGCAACTCCCACTCTTCCACCTTCGATGCCGGGGCTGGCATTGCTCTCAATGACAACTTTGTCAACTCATTTCCTGGTATGACAATGAATACGGCA	574	584	110	100	-10
2G5Z3:03872:06993	INITIAL_QUERY	GTAGCTGTTGGTGGGCTAATATTTATTAATACTAGAGTAGCTCCTCCGATTAGGTGTATTAATAAGTGTCCTGCAGTAATGTTAGCTGTAAGCCGGACTGCTAATGGTCATTGGTTGAATAAATAGGCTAATTGTTTACAATAATAATAAGTATTGGAATTATTGTAAATTGGAGTTCCTTAA	183	193	67	57	-10
2G5Z3:02579:09693	INITIAL_QUERY	GGCAAATGCTGTAAATTTAGAACCTTTCCCTATTCTGGGAGCACATTTTAGGAAGGTGGAGAAGATCTTTGGGTGGATGGTGTGGGTTCTCTGAGACTATGGTGGTGGAGGGAGATCCTGAGGGTGTAGGACTTAGAAAAGGCGAGGAGGTGGGCTGGATTGTGACGACAAATGCTAGGTCCAATTTCTTCATAATCCTTTTTGGTGTGGCATACTTGGTAGAACTCAGGCGTGGAAGCCAGCAAGAGCAGTATAATAAAAATAGTCATTCCCAAATGAAGAAAATGTGGTCATCTATTACAAGATTAGACAGCAACTTGCCAAGCTGGGAAAAGAGATTGAAGAATATATTCATAAACCAAAAGTACTGCTTACCCTTTCTACAGA	304	314	110	100	-10
