name	sequence	query_start	query_end	seq_start	seq_end	length
2S43D:09033:12621	GGATCGTCCTCTGTACCCCTGGTTGCACAGGGTAGATCAGGCTGGTTTCGAACTTAAGAGATCTCATTGCCCCTGCCTCCGGGGTGCTGGTAGTCTTTTGTGCTACCATTGCCTGGTTTTTGTATTGTGATTTATCTCTTCGTCGCAGGGTTATCCTGACGCCCCTGAGGGGGAGGGATTTGATGGACTAAATTCCCATTTAGGGCCCATCGCCCCCTCGTCAGAAAGGCCTTGTCCTTGCAGGCTTCCAAGACACCGCTAAGGTTAGCCTTTGGTTGGAGACAAGTGCTCTAGCCCAGACACTGGAGTAAGGCGCTGAGACCAACGAGGCAGGCCAAGATGGAGATCTATGGAAGGCCCTTGCTGGCGGAAGTGATCAAAACTCATCCAGTACTTCCACAAGACTGTCTCGATTTGATTGACCAGAAGGTGTACGAGCTTCAGGCCAGCCGCGTCTCGAGTATGTCATGACAGAAGGTGTACGAGATCCAGGTACATTACGAGACAGCTGGACCAAGCTAACTGAAAGGTTCTTATTACTAGAGGTAGAAATACAGGCAATATACTATTACGGCAACAACCAGATCAATTATACAGTTAAGTAATTTTTTCTGTAACAACCAAAATGGATAATGCCACTCCAGGCTGTCCGTTGGAATTGTGTGGAAGCTCAGCTGTGTCAGCGCACAGCAGGACGGGGAGCAGCCAGGGGCAGGGCGCGGGGGTGGCAGCCCCTTCGCCACCACGATCAAATTGGACTTTTCCTTTCGGG	122	132	677	687	10
2S43D:02267:06838	GCTCACTTGCCCACTTCCTTCCACAAGGAACTCCAATTTCACTAATTCCAATACTTATTATTATTGAAACAATTAGCCTATTTATTCAACCAAATGACATTAGCAGTCCGGCTTACAGCTAACATTACTGCAGGACA	183	193	126	136	10
2S43D:01408:07960	CTGGTTCCGTGCTTTCCAACGCTTAACATCCTCTTCCAGTAGCTTCTTTTCTGCCTGGAGCATACCGCTTTTCTCACTCAGCTCAGCATTGGCTTCTATGCTTTTGTAACTTTTGATGATCATGACACAGTTGATAAAATTGTTGTTCAGAAATACCACACTATTAATGGGCATAATTGTGAAGTGAAAAAGGCCCTTTCTAAACAAGAGATGCAGGCTGGTTGTGGAGTAGATAGAAAAGTGAGCTACAGAAATGCAAACTGAAAGGTCAGAAGTACGGAAGTGGTTGTATATGCCCTATAATCCAAGCCCTTGACTGATGGAAGGGTATAGCCAGTTTGAGCTACGAAATGAGAACAGTGGA	609	619	64	74	10
2G5Z3:08090:01694	CTGGGACGGCCCGCTGCCAACACGAAGATTGGCCCTCGCCGCATACACACAGTCCGAGTTCGAGGAGGCAATAAGAAGTACCGTGCCCTGAGATTGGATGTGGGGAACTTTTCATGCAATGCGGCGGCTGCATACGCTTGATCCGGCTACCTGCCCATTCGACCACCAAGCGAAACATCGCATCGAGCGAGCACGTACTCGGATGGAAGCCGGTCTTGTCGATCAGGATGATCTGGACGAAGAGGCATCAGGGCTCGA	359	490	113	244	131
2G5Z3:05145:01866	CCGGTGGGGCGGGGGGCCCGGACACTCGGGGGGGCCGGCGGCGGCGGCGACTCTGGACGCGAGCCGGCCCTGCAGAAGAATCCATAGAGAACATGGGCACAACAATCAAATAAAATCGCAAAAATGCAAAAAAAAAATCCTAACTCAAAACATCCAGGAAATCCAGGACACAAACCTACGGATAATAGGAATAGATGACAATGAAGATTTCAACTTAAAGGGATCCAGCTAAAAGTATCTTACAAATCAAAATT	76	87	93	104	11
2S43D:09191:05461	CCACCGCATACTCCAACGGTTTCCTGGTCCCTTGTTTCCAGGTCACCTTTATCCCCTGGGCTCCCATCAGCACTGCTCACTCCCACGTCACAGGGGGCAGGATTCTGGAGCTGGAAGTGGGAGA	300	310	93	103	10
2G5Z3:00179:11389	GGCACGGGCCTATTTACAAGGGACTTGGTGAATCGGAAAGGGTGAGAGCAGGGAGGGGGATCCCTGGCAGAGCCGTAATATTCCTATGTCCCTGGCAGCTCAAGTCCTGCTGCCACCCCAGGGGAGAGGCCCTGAGGCTGAGCTCCTAGCCAGTACTGTGACAGCACCCCTCGGAGCTCTCCTCCCCAACAGGTACAGATAAAGGTGCTTGTTCAAGACCTGGGACCCATTTGTGAGGAAAAGACTGACCTAGCCCAAAGCTGATCCCATTCAGCCTTTGCTCTATGTAGTGTAGCGCTCTCGTCTACGTCTCTGTTCTCTGTCATGTGACCCTGTGCCCCACTTCCTGGGGTGCCTATGTGCCTGGTTCATGGCCTTGGAGCCATGGTCAGGTCACAGTCCGGTGCCTTCCACCCCTATGGCAAGGCGCCCTCCTTGGCCTACCACACGCTGCCTCCAGGCTTAGACCTGGCTTCACCGCCA	165	175	398	408	10
2S43D:03492:07354	GAGGCTCCCACCTAACACCAACGATGAGGTGGATGAAGATCCCACTGGAAACAAAGCCCTGTGGGACCGGGGCTTGCTCAATGGGGCTTCACAGAAGGCAGAGGTCATCATGAACTACCACGTTGGAGAGACCGTGCTGTCGCTACAGAAGACCACACTGATCCCTGGAGGCTCAGAGTCCCTTGTCTAAAATTGTTCGTGACATAAAGGAGAAGCTGTGCTATGTTGCCCTGGATTTTGAGCAAGAAATGGCTACTGCTGCATCATCTTCCTCCTTGGAGAAGAGTTACGAGCTGCCCGACGGGCAGGTGATCACCATTGGCAATGAGAATGGCAAGACCAGCAAGAAGATCACCATTTCCGACTGTGGACAGCTCTAATTTCTTTTGACTTGCGGGCATTTTACCCATCAAACCTTATTCCTTCTGTAGCTCAGGAGAGCGTCCACACATGAAGGCTCACAACCATCTGTACAGCTACAGTGTACTCACACATATAAAATTTAAAAAAAAAAAAAGCCAACATTCGACAGGATAAAGGTGTCCAAGGCAGCTGCTGACTTGATGGCCTACTGTGAGGACACCATGTCCAAGGAAGGACCCTCCTGCTGACCCCCAGTCCCGCCTCAAGAAAACCCCATTTCGGGAGAAGAAAGTTCAGTGGACTCTTTCTGGATGTTGTAGTCTGACAGGGTGCGGCCATCTTCCAGCTGCTTGCCTGCAAAGATCAGCCTCTGCTGGTCAGGGGGGGATGCCCTCCTTGTCCTGGATCTTTGCCTTGACATTCTCAATGGAAAAACAGGACAGCCATGATCTCGGCAGCGCTGCAGCATGATGTGGGGTGGCCTGAGCTGCCGCGAGTGCGAGGCTAGGATGGACTGAGCGCAGGCGATTGGCTGTGTCCTTCAGGGCCTGGAGCTTCTGA	539	549	294	304	10
2S43D:07792:07633	AACTGAAGCAAGTTAATAATACAGGAGCAGAGCAGAGGCCTTCTTGTTGCTTCTTCTTTGCTTTGGGGGTTTTCTTCCTCTGTCTTCGGGCACGTGGCTCCTGCTGCTCTTTTGTTTTCTTCCAGGACTTTGGCGCAGTGGTAGCTGTTTGCACTGGGGCGGGGCTCCTTCCTGAATGTAGGCTCTGGGGATCCGCAGTCTCTTCTGCTTGCCATCTGAGGAAGATTTAAAAAATTTTGACAGTACATAATTTACACAGAAGCAATGCTGTCACCTTCCCGGGTGGAGCAGGGCTGGACGGCGACCATCCTCACATGTCCGGCACATGGCCTACCAGCTCTGTCATGCCCTTAGATTTCTACACGAGAACCAGCTGACCCACAACAGACTTGAATGGAGACAAAGTTTGCTCTGTGTATATCTCTTTGG	80	90	379	389	10
2S43D:01876:02683	GCGGGCAGGACTGAGAGCTGAACCCGGCGGGCCAGACTTCTGCAGGGGTACCTCCCAGTCGTGGCGGGGCGGGCAAAGGCTAGCTAGAGGGCCACAGTACAGCGGCCAGCAGACGCCGACCCAGCTGGCTCAGCTCCGAGAGTGAGCCTGGGGTGAGGGGAAGAAAAAGAGGTACAACAGTGTCCTGTTCGGAGGTCTCATCGGCTCGGCCTTCTCCCTCCTGCAGTTCTTCTCCGCACCACTCACAGGAGCTGCCTCTGATTACCTGGGGAGGCGCCCAGTGATGATGTTGTCCCTGACAGGTTTTGGCCATCTCCTATGCAGTGTGGCTACCTCTCGGCTCGTCAATAGGCTCAGTCATATACACCACCTCGAAGCCCCGCTTCCGCACTCGCTCCACAAAGGCAGAGTTGGCCACTTGCTCTTTGCTCTCACCAGTGATATAGTAGATGGACTTCTGGGTCTCCTTCATGCGAGACACATAATGCCTGTGACATGGGAAAGGGGTCATTAATTTGTAATTTCTGGATTTAAACACATGATCATCAGCACGAGATGTTTTTCTTCCAGCTGTTTTCTTTTTTGGTTTTCCTGACAAGGGGGTCCTGCTTCCTAGCTCA	614	624	521	531	10
2S43D:04706:09633	TTTTTTTCAGAGCCAATTTTACATCATCTTCTGACTCAAGTTCAACAAAAGCCTCACCACTCTGCCTGCCTTCTCTAGTATAAATGAAATGAACACCTGCGACCCATCCATGAATTGTAGTAGTGGAGAGGAAGTTTGTACGTTCCTCAATTGAGCAGGACCAAGTGGCCCAGCTCCTCCCTCCTCATCTTGCCGTCCCACTGGGTGCTAGGAATCCAGGATGACGGCTGCTCTGATATGGTGCTCTTCTGAGGTGGCATAAGGCTGGCCCTTATTTGCTCTCCCTCCTCGCTGCAGAAATAATTTAATTAATTAATTACTATATTAAAGCCCTTGGTGTTTGGTCTTTATAGAGGGGGATAAGGGCAGGGTAAAAGGGCAGATCGGGACGGAGGTTGCGCAGCAAGGACCGGGCGGGAGGACGGGAGCTGTCGGTAAAGGAGGGGGTTTTGGAGAGAACAAATCGGTTTTGAACCCGACGGAGGGGGGGTCAATTAGGCAAGTGCCTCCCAGGTGACGATATATGGGACTTTGAAACATCATTCTCCATTCAGATGGTATCTATGGTTCTACATTCTTCATGGCTACTGGATTCCATGGACTCCATGTAATTATTGGATCAACATTCCTTATTGTTTGCCTACTACGACAATCTAAAATTTCACTTCACATCAAAAACATCACTTCGGATTTGAAGCCGCAGCATGATACTGACATTTGTGACGTAGTCGACTTTTCGCTACCGATACATTATATTTTACTTCTACTCACAATCTCAGAATTGCGAGTTAGCATTAATTCAAGCCTTCGACCGCTTTTCGTTTTCTTTTCTCTTTCTTTCTCTTCTTCTTCTTCTTTCTTCT	93	106	224	237	13
2G5Z3:08143:13099	GGACTCCTAGGGGAGAGGATTGCTTTACGGACTCAGTGGCTCGGAAGTCTGAAGAGCAGTGGTCCTGTCCGTGGTTTGTACTCTCATAAACAGACCCTCGGCTAAGGCCTGTGATGCTTGCTTGACCACAAGGCCTCTGGATTCAGTGCTCAAGAATAGAGAAAATTCCATATTCGGAACCTGGTACACAGTGGAGCCACCAAAGGGGAGATCTCATCTACACAAGATGCCATATGGAGGAGATATCAGAGTAGGTGGTT	616	626	135	145	10
2G5Z3:05469:00339	GAAAAACCAACGGTGCCACCGCAGTCTTTAACACTGGTATTTTCCAATACCAACAGGCTCTAGCCAACATGCAGTTACAGCAGCATACAGCATTTCTCCCACCAGTTCCCATGGTCGCACGGTGCTACGCCAGCCACTGTGTCCGCAGCAACAACATCTGCCATCTGAAGTTCCGGAAGAGCTCCTGATGCTGAGGCTGGACTGCAGACTGGCCATGTTTCTCGATCGGAGTTCAGCCTCAATGCACCAGCTATCACAGAGCATTTTCTCATGCTGTGCCGTCGGATGGGGACAGCAGCAGGCCCATCAATCAAACAACATCTTTGAGCAATCCCAATGACCGTTTTCGATGGTCATTGCTTCTGGGTTCTGATGTCCCAGCCGAAGGAAGGGTGAGCCCTAGCAGTGTAGTTACAGCTGGATTCATGCAAGTGGGGTAAGTGATAATCAGAAGAGAAAATAATGAATCTGAAAATTAGTGACCCCCCATAGTTTAATTGCTGACATTTTTTGTTCTATTGAGTATCTAATTTGAAAAAAAAATCATATAAAGATGACAACGGCAGCATTTATAACCCTGAAGTGCTCGACATCACAGAGCAGCCCTGCACTCTCGCTTTCTGGAGGGTGTCCGCACGTGGCCAGTGTGTGTCTGCGAGATCGGGTACCAACTGTTGCCTCGGA	617	627	417	427	10
2G5Z3:08521:05110	CCCCCCCTTTTTTTATTTTTTTGATTTTCTTAGACAGGGTTTCTCTGTGTACCTGGCTGTCCTGGAACTCACTTTATTTGTATTCTCATCTCACACAGATTCAGTGATCAAACACTTCTTCCTCCCAAACCCATCACATATCAGCTCATTCAGCTCACTGTTCTGGATAAGAGTGGAGGAAAATGGCGAGTGATGGTGATTCTTAGGTCTGGCTGCTACCAGAATTATCTGACTGAGAGCCTGGGTGTGGAGGCTGAACGTGACTGGTGGGGTGGCAGCTGGACCGGGGGACCATGCGTGGCATGGGAGAGGTGCTGGGCCTGGAGTTGCTGCTGCCCGATGATGGCGTTCAACTCCGTCATGGTGCCTGCTTGGCGCGTTCCACAGCCTGCGCCATCTTGCTGCTGTGCTCCTGTGACAAAAAAAGGCATATTCTGGGTCTAGGATTGTGTTCAGTCTCTTCGGCAATCTCTGTCTGCTTGTGCATTTCAATATTCAAGCCATAA	276	286	208	218	10
2G5Z3:07075:04811	CCCCCCTTTTTTTTTTTATTTTTATTTATGTGCATTGTATGTTTTGCCTGCATGTCAGTCTATCTGTGTGAGCTGTCAGATTACCCTGAACTGGATTTACATCAGACTGGGCACCCTGACCCTGCTCAGGCTAAGACCAGGAAGACAGGCTCCCTGCTCATCCCTGCCTCGGGGCAGGGGCAGGGGCAGGGGCAGGCACCCTCGCCCCTCCCCCTCCGCTGCCTACTGTC	73	83	104	114	10
2G5Z3:06274:13859	GAAAACACACCCATTATTTAAAATTATTAACCACTCATTCATTGACCTACCTGCCCATCCAACATTCATCATGATGAAACTTGGGTCCTTCTAGGAGTCTGCCTATAGTCCAAATCATTACAGGTCTTTTCTTAGCCATACACTACACATCAGATACAATAACAGCCTTTTCATCAGTAACACACATTTGTCGAGACCGTAAATTTACGGGTGACTAATCCGAATATATACACGCAAACGAGACAGAAGTCATAAACTATGAGTTAAGTCTGTGAAAGAGGCTCAAGTGGAGGTGATTCATTCTTTTGAAAGCCGTTAACGTGCGTAACTTGATCAACTCCCGTACTCAGAACCAC	392	404	46	58	12
2G5Z3:00092:07899	GTCAGCTTTGCAATGAGGTCTTTATAAAAGACAAAAAGGAAGCCCACGAGGGACTCAGGTAATACAAGGAAAGATGGAAGAAAAATATCAGGGCTGCCTGAGCCCTCACCCTGAAGATGGGCTGAGATCGAGAAATTCGATAAGTCGAAGTTGAAGAAAACAGAAACGCAAGAGAAAAATCCTCTGCCTTCAAAAGAAACAATTGAACAAGAGAAGCAAGCTGGCGAATCGTAATGAGGCGAGCACTCTCAGCTGTGGTGGTGAAGCTGTAGCCACGCTCGTCAGGATCTTCATGAGGTAGTCGTGTCCAGGTTCCCGGCCGAGGCCCAGGGTCCGAGTGACGGCGAGG	10	21	201	212	11
2S43D:00073:10455	GGGCGACGTGATCTCCGGCCGGTCCCACTGGTAGTCGAGCAGCGTCTCCATCAGGGCACCGTGCGTGTGGGTGGCTCTGGGCGTCGGGCCCGGCAGGTGAGCTCCGGGAGGGCA	37	47	11	21	10
2S43D:06281:04609	TGGCTACGTACATGGCTGGGGTGTTGAAGGTCTCAAACATGATCTGGGTCATCTTTTCACGGTTGGCCTTAGGGTTCAGGGGGGCCTCGGTGAGCAGCACAGGGTGCTCCTCAGGGGCCACACGCACCTGAATAAATTTCTTGATCTTGCCACTGGTCATTTTCTTTTCAGTATATGCCACAGTTTTGTCTTCAAACTTGTTAGCAAGATGTAATGGACGGAATATAGTGATCCCCTCTCCATTATCATTCGTACTCCTTCACCAGAGACTCAATGTTGGTGTGTGCAAATCGGTAACAGCACAGACCACACTACAGTTGGCTGCCAGGGGACCGGTACCAAATGCCCCGGCACTCTCGTGCACAAAGTCCCTGTCACTGCTCGAACCGAATCGGGTGACATTGCAGCCCTTGCGCAGCGTGCTCGACGTTTGTCACTGAAGCGGGGAAAGGGACTGGCTGCTATTGGGCGAAAGTGCCGGGGCAGGATCTCCTGTCATCTCACCTTGCTCCTGCCGAGAAAGTATCCATCATCGGCTGATGCATGCGGCGGCTGCATACGCTTGATCCGGCTACCTGCCCATTCGACCACCAAGCAAACATCGACATCGAGCGAGCTAACGGTCCCACTTCCTCCTGGGCTCCAGTGTCCAGCCAGGGCCAGGGAAGGGAGCCACAGAGTTAACGTTTTTCTAACCTTGCTACTTGGAGGGAAGGGAAGGTTGGGGGAGAGGCCTGCTTTCTATCTCCCTCTTCTACGAGCTCTCTGAGAACGACCTGAACTTCATTAAGCAGAGACAAGGATGGCTACAGGGCTTCCCGTCATCAACCTCATCGACTCTCCAGCCATGTGGACACCCGTATTCTCCCGCAGCTGGAGGTGTATGCTCTCGTCGATCGCATCGGGTACCATGGTGAGAGCCAATGGCCAGCAGAGCATGCATCTTGCTCGGTTCTGCTTGTTAATCAAA	293	354	472	533	61
2S43D:03587:13524	GCGTTTTTTATGGACATATCGATTGTGTTTGGTCTCTGTTGAAGCATGGTGTTAGCTTGATATATGCAAGATAAAGAAAGGATTAGTCACCTTTGGATCTTGCTTATGAAGGACAGGCAACTCATGTTGTATTTAAGGACACTGATCCCACAGAAGTCTATACTTGGGGAGATAACACAAACTTCACATCTGGGCCACAGTCCGATCCTAGGGTCACGCAGGGTCACCGAGGTCAAGTAGAGTCATCCGGCGTCAACGGCAGGTCAGGGGTCATGGCAGGTCAGAGAGGTCACCGGGGTCAAGCTGGCTCAAGGCGGGTGACTGAGGTCAC	524	535	305	316	11
2S43D:02563:08718	ATTTACGACCTGAAGAAATTTCCAGCTAAAATTGGTGCAGGTAAATATACAGAAAAGCTTCTTAGAAAATATAGGCAAAGTCTATAATGTAAATTATCTACTGCAATAATTAAAAATAAAATGCTATCATTAGAGAAAATGCTGATTCTAGGACTGGGACTGAGGGTGGCATTTATCAGCTTCTCGTCTTCCTTGCACCTCCTCCCGTTTGTGCCGGTCAGGGGCTGACCACTCGCATAATCACCATGCCATTCTTTTTATGGTAATAGCTCAGGACTGGGAGCGCCCCCATGTCGAAGGCTGCTACCTTCCGAATGCTTCGTCATCGTACGGACTTGGGCACAATGACAGTTGGGTGGGTAAGAAGGACAATGGATATTTACTGACAATTTGGAGCTAGATGAAGAAGGAACAGGCGGGTTCACGGCTAAAGCAATCGTTCAAAGAGACAGAGTGGATGAAGAGGCCTTGAATTTCTCCTATGAGGATGACTGGGTAGGTAGGGTTGGCTCCATTAACCTGATATGGTTTCACATCCTTCTTTCTGCAGGATATCTAGATGCTCCCACACGGATATCCCCAACCAAAGTCCTGGACGCCAAGCCATCGCCCAGCCCTGGACAGGCAGACAGCTACTCAGCTGCTTAAGCTTGCCCACAAGTACAGGCCAGAGACAAAGCAAGAGAAGAAGCAAAGGCTACTGGCCCGTGCTGAGAAGAAAGCTGCTGGCAGGAAGTGAAAGGGCACACATGGCAGAGCGGACAGCTCAGCCTCGTAGAAGTGGAAGCAGATGACATGATCAGTGCTGTCAAGAGCAGAAGGCTGCTTAGCATGCAAGCTAAGAGGAAGCGGGAAATCCAGGAGAGAGAAACAAAAGTGAGATTGGAACA	262	272	845	855	10
2S43D:03006:13797	GGACATTCAAGATATGCTCCAGGGAGAAGACTAGGAGGAGATCGCCCTGGAGCCTATTGGGAAGTAGATTTATTGAAGTAAAGCCAGCTAATATGGTAATAAATATATTTAGTTTGTATAGACACTTTTCAGGATGGGTGGCAGCCTACCCAAACAAAAAAAAAACAAGTTCGGAGATGGGGGTTCGTGGGGCAGGATTTCATCTTTAGGTTCCACGATGCTCACATGATCAGGGCAGAGGCTTCCTTGGGACCAAGTCTTACCACTTGGGTCCCAGGGCAGCATGATCTCACTTTGATGCCCAGCACACCCTGTCTGAGGAGCACAGTGG	300	310	188	198	10
2G5Z3:01895:09209	GTAGATACCGTCACTTTTCCTTTTGTAGATGTACTGCTCCATCTGAAAGTCAAGGTTGGTGCCACTAAGTGGGTCCGCAGCAAGGAATTTGAGGACATCCTCCTCCTTCATCTGCAGGACGCAAGGGCTCCGGACATTGTGTAACGTTTCCCTTTAAGTTACGATGGGAATCAAGAACAACGCCATCGGAATCCTTCAGTCCCGACTGTAGGAGGAGCCTGGTGCAAGCCACATGCTGACCTGCGCAGGCCAGATGCAGGACTGAGCAGATTTCTTTCATCTTGTAGAGTTGATGTCGGCACCCAAGGACAACAGAGTTTGAACAAGTTGCATGAAGTTATCCTGACAACCCACCAGCCAAGGGCCGTAATTAGAAATCATCAACCCTTGTTATTCCTTA	184	194	111	121	10
2S43D:01688:03251	GTTTTCTAGAGGCATGAAAGTCAATGTATATATTATGGTAGAAATAATATTGAAGGAAATTGTAATTCACTAGTGCTGCCAGAGGGATTGCTAACAAAGCACCTTTAGGAGAGATGTCTGCAGACTGAAGGGACTGTGTACTACTGTTAATGTCTAAGACCCGACTGCTCTTCCGAAGGTCCGGAGTTCAAATCCCAGCAACCACATGGTGGCTCACAACCATCCGTAATGAGATCTGACTCCCTCTTCTGGAGTGTCTGAAGACAGCTGACACAAGAGCACCCGAAAGCAAGGAGAAGAAAGAGATCTGAGGGAAACAAAGGATGGCACCCCAGCCCTGCCAAGGAGGGGAGAGGGACTGGGAGAAGAAGGAAAGACAACCATGTGGGA	269	279	126	136	10
2G5Z3:04492:01426	GGGGTCTGTGGTGAGTGGCTGCTTCATATAGTAAAACGGACCATGTCTTAGCTCTGACTGTTCCTTATTGCTACTGTTGAGTAAGCCGGGTTTCTTTTTCTTTTTAATGGGGCTCGTGGATGAGTCTTGGGGCGAATGGCCATTGGAGGAATGTGGAGGCTGGGGAACCTCCGTTTCGGGGCCGAGTGCGGAAGAACAAAGAATCCAAAGACCCCCGCGGATGAGACTGAGACTGCCAAGGCATCACCGAGGGGAACTAGGTTGCTTACTGTGATGTAGTCCCAGGACGAGGATGGTTTCCAGGATGCTCGGCTGTGGTTCGCAGCCCAAGAGGCACAAGTAGAAGGATTCTGGACCACCCACGATGACCGGGCCCACCGGGGGGCGATGTGGCCGGGG	187	197	282	292	10
2S43D:04807:10464	CGCCACTCCGGATTCGGGGATCTTGAACCCGACTCCCCTTTCGATCGGCCGAGGGCAACGGAGGCCATCGCCCGTCCCTTCGGAACGGCCACTCGCCCATCTCTCCAGACCGACTGACCCATGTCAACCTGTCTGTTCACATGGAACCTTCTCCTGCATATCACATAGTTAATCCAAGTCCATGACCATTAACTGGAGCCTTTTCAGCCCTCCTTCTAACATCAGGTCTAGTAATATGATTTCACTATAATTCAATTACACTATTAACCCTTGGCCTACTCACCAATATCCTCACAATATATCAATGATGACGAGACGTAATTCGTGAAGGAACCAGTTGTCTGAGAAGCCATTGATCTCTGAGGAGACAGACCTCATTGAGCCTACCCTCCTGATGAGCTCATCTGCACATTGGTTCTTTGGCCTCTGTGTACCACAACCTCCAAATGCTTTTGTGGAAGGGAGTCATGGGATTCATCGCAAACGACTTG	619	629	470	480	10
2S43D:09037:05922	CGTGGATGAGTCCTGCGCGTGACCCATCTTCCAGTTTGGGGCGCATACCTCCTTCCTTTCCCTTCCTTCCCCGTACCCTGAAGCTTCTGGAGTCTGGATGATTCAGAGCCGACACGAAGCTGTTGCCTCGGTGCCACACTCCATCATCAATGGGTACAAGCGCGTCCTGGGCATTGTCTGTGGAGACTGAGTTACACCCTTCCCACTTACTGAAAAAGGTCCAAGGCCTTTCCCTGGCTGATCCATCTGCATTTGCGGCTGCTGCCCCTGCAGCGTCGGACGAGGGCCAGCTGCAGGGCGACATAGAAGATAATTTGGGGATCATCGGGTGCCAGTTCCCGGGCTCTCTCCAGTGTCTGCAGTGCCTTGCGGTGAAGCTCATCTTGCTTGGACTTCAGGGTGGCATCAGTGGCCTGCAGGCA	561	571	17	27	10
2G5Z3:04433:05017	GTAGCGGCGAGGATGTGTGATGGCTTCCTTGCCTCACATACACACATGAGATGGAGTCTGGTAGCTTCTCAACCTCCTAATGTTGCGATCTTATATTCCTCATGTTCCCCATGCTGTGGTGACCTCCAACCATCAATTGTTTTGTTGCTACTTCATAGCTGTTAATTTTGCTACTGTTATGAACTGCAATCTCCTTCACTTGGGATTTAAACCCAGTGCACTTTACCACTGAGCTGAAACCCTAAGTCTCTCTTCTCCCAGAGTCTTTTTCTGCCGAGAACAAAGCAAAGCACTCGCCCAATGACATTCTAGGCAAGTTGTCTGACCGTTTTTA	179	189	178	188	10
2S43D:03717:03483	CGGGCCTCCTGTCTCTTGAAGGTTAGGTGCATCATCTCTGAATGAACAGACCTGGAAGTCCTCTACTGTATGTGTGTTGGGGGTCTCATATCAGCTGGTGTACTGTTGTCTGTTTGGTGGTCCAGTGTTTGAGAGATCTCAGGGGTCCAGATTAATTGAGATCTGCCATGGTCCTCAGGCACGATCAGCCCTTCTCCTC	175	185	37	47	10
2G5Z3:06603:04299	GTATCATCAAGGCCTTCCGCAACATCCCTGGTATTACTCTGCTTAATGTAAGCAAGCTGAACATTTTGAAACTGGCTCCTGGTGGGCATGTGGGCCGTTTCTGCATCTGGACGGAGAGTGCTTTCCGGAAGTTGGATGAGCTGTATGGCACTTGGCGGAAGGCTGCTTCCCTCAAGAGTAACTATAACCTGCCCATGCACAAGATGATGAACACCA	394	404	186	196	10
2G5Z3:03881:02656	CTGCCTTCAGGGACACTTTCACTTGGAAAATTACAACACTAGGAACAAGTCAAGGCTCACACATCTACCATTTGCTTGTTGAAAGCAGCTCATACTAGCAAATAAAATTAAATCACTGTACTTACTTTTTCCAGTGGGAGAGAAACCAGAGGACATGCACAGGAAGTCAGAAGGACACTTCACCTAGCCATGTCTGGAGCCAGAAGCTTCCATGGCCTGTACTAAAGAAGCAATGTGTACTGTGCCAGCCACAAATGCATTATACTAACTTATGTTCACTTTCTTTTCTGTCAATTCCTTGATCCTCACATTATTGATGTGTTTTGCATGTCGCATGGATTCCTCTAGGTTTGTACAGTGGGGCGCAGCACTCCAGGTGGCCACGTGACAGAGCAGAGGGCGGAGCCTTCAATCCCACTACTGCGGAGGCCAAGGCAGGAGGATCTGAGTTTGAATTTGAGGTCAGCTTGGGCTACCTATCAATAAAAGTGATCCAGCGGGGCCGGCAGAGCAAAGGCCTGACCCAGAAGGACCTGGCCACGAAAAATCAATGAGAAGCCGCAAGTCATCGCAGACTATGAAAGTGGACGGGCCATTCCGAATAACCAGGTTTTGGGCAAAATTGAGAGAGCCATCGGCCTCAAGCTCCGGGGGGAAGGACATCGGGGA	214	224	533	543	10
2S43D:07918:02143	TGAAGGTGCCTTCCAAACAGAGTTGGGTGACCATTCCCCGGGAACAGTTCACCATGGCTGACAAACTCCTCATCTGGGGGACACAAAAGGGACGGCCTCTGTGGTCCTCTGTCTCTGTGAACCTGGAGACCCAAATGAAGCCAGACACATTCCATTTTCAACAAGTTCTTCAAAAGAGATTGTTCATAAAGTTTAAAATTTTAGAAAGATATTTAGAACAAGTTCAGTCGTGTAGCATATGTAAGGTCCATACCGTGCCCATCCTTCAGTGGGCAGGGGCAACTCCACAGTGGCACTGTGCTTCCTACTGACTCAGTAGTGCTTAGCTCCCAAGACCCGCTCCTCAGTCTTGTTCCAGTGGGTCTTTGAGTTGCGGTATAAGGACGGAAACATGATGGGCAGAATCTTCGCTGCGTTGTCACTGATTAAACTCATGATGTACTCGTTGTTCCAGTAATAGAGCGCCCGCTCGGCCACCTGGAAGTGAGGGCTGGAAACACATTTGGCTAACTGTCGA	252	264	413	425	12
2S43D:07885:10933	GTTCGGAGCAGGTACACTGACTACAAAGTCATCAGTCACCATGGGACAGCCAATGAGGTCCAGAGAGCAAATGAAGGGCTTGAAGGTCTCGGGTCCAGGTCCTTCTTGGTTGAGCAGCAATGGGTATTGAAAAATATAAAACACTGAACAGAAATGACTAAAAGGAAATGGGTCTTGAAGTTGATTGGAGACCTGAGCGTTTTCATCTTGAGACATTGATGATGGAGTGTGGCACCGAGGCAACAGTTGGGTACCCGATCTGACAGACGACACACTGGCCACGATTGGCGGACACCCTCCAGAAAGCGAGAGTGCAGGGCCTGACGTCGTAGTGACTGTCGAGCACTTCAGGGTCCTCGCAGCCAGCACCCATAGAGGCAAGCACACCTCAAGCCAA	214	224	274	284	10
2S43D:08591:13321	TTTCCAGTGAAATAGCGCTGCCTTCTCAGTCATCTCATACCTTTCTGTGTGACCCAAACTGAGTGCCGCTGTTTCCCAACTTAGAACAATGCCCATAGCTCATATGATAAGTGTCTCCACCTGTTCCTTGGCTCCTTCAAATGAGATTTCCAAGGAAACCAAATAAAACGTCAAATAAATTTGAATAGGAGTCCAGCCAAGGGCCCAGCCAGAGCAGAACCTGGGCTGGGGGAGGGGCCTCTGTAGCTCATGGATCACTGCTGCCACCACCGCCACCCTGGAAGCCGGTTATTTTGCCATGGCCTTGATTGCAACAGCAGGCCAGCACGGATTCCCCCTGGTATCCCTCCAGGAGTGCCAGCAGAAGAGCGCCCGCTGCGCCCAGCCGGCCCCACCATTACTCCGCCCCAGCCGTCGAAATAAAGCAGCAACATGAAAGCACACAGACCAGAGCTCTGGGGTCGAAATAAAGCAGCAACATGAAAGCACACAGAGCTCTGGGGTCGAAACTCATACACCTTTGCACAGGGTAGAGG	449	460	278	289	11
2S43D:02405:08262	GCGCTTAAATGTATCCCGATGCAACGGACAGGTTCAACTTCTGCGTCTTAAGAATTGTCCTTTCAATTTTTATACCGTCAATTATCTCGTTTGTTATACAGGATTTCAAGGTCTTTCTTCACTTCTTGACACAGTTAACACTTGGATTTACATGATCTTTTTTGTGTTTTGCTTTTTTTTAAAAAATAAAAGTGCTTTGTTAATTTTTGGTTAATTTTCCTTCCCCAATTAATTTTACCTTGGGAAGTTAAAATTTTATTCCTTAACCTTTTGGAATTGGTTTTTTAATTTAAGGGTTCCGTTGGGGAAAATTCCAACCCCGGAACCTTGGCCCCCCAATTAAGGAAGGAAGGGGCCTTGGAAGGAACCTTTGGGAAAAGGCCGCATGATCTTTCTGGCTCCACTCAGTGTCTAAGATACCCGCTCCCCTGCTTGCCTCCCACAGCCTCCCCTCATCCTCTCTCAGCCCAGCCTCGCCTCAGTTCGAGTCTTGTTGTTTCATTC	578	588	427	437	10
2G5Z3:06006:00817	CAGGGTTTCTCCATGAAGTCCTGAAAACTCTCTTCTGTAGTATAGTCCTTGAACTCACAGAGCTCTGCCTGCCTCTGCCTGCCGAGATGCATGGGATTAAAGGCGTGCACCACTACTGCCCA	331	341	77	87	10
2G5Z3:04341:00882	GCCGGTCTTGTCGATCAGGATGATCTGGACGAAGAGCATCAGGGGCTCGCGCCAGCCGAACTGTTCGCCAGGCTCAAGCGCGCATGCCCGACGGCGATGATCTCGTCGTGACCCATGGCGATGCCTGCTTGCCGAATATCATGGTGGAAATGGCCGCTTTTCTGGATTCATCGACTGTGGCCGGCTGGGTGTGGCGGACCGCTATCAGGACATAGCGTTGGCTACCCGTGATATTGCTGACAGGGAAAACCTTCACTAACTAGAAAATATCCTGCACAGAGTCCCAGTGCTCTGCGATTCATCGTGAGGTTGATAGGTTTTAGAGGTTACGTGAATCAGCTTGGAATTTTTTATTCTTATTGATGCAGTCGTCGTCCTCCTCCTCCTCGTCGTCTCTC	454	532	0	78	78
2S43D:08890:04655	CCCCTTTCCCTTTCTCTTTTTCCTTTTCCTTTTCCTTTTCCTTTTCCTTTTTTCCTTTCCTTTCCTTTCTTCTTCCTTCCTACCTCACCCTTGTTCTCCGCAGATACCAGCCCGCCCTGTCTTGCTCTGCCCATTCTCTCAGAGCCATCACCCAAACAGGCCAACCATCTACCT	396	406	126	136	10
2G5Z3:07223:07623	CCCCGCGGCCTCCACTGAAGCCACCACCACCATCGCTGTGGCTGGATGCTGGAAGAGTCCTCCCTGTTTGTGGACTCAGGATGACAGACGCAGCCAGTCCGAACTTGTATTCCCCCAAAGTGAAATTCTTGTTTTCTGCATGGTACCTATAAATGACGCTTTCGCCAGCTGCACATCTTCCAGGGACTCGGCAGCAGGTACAGCAGGCGTTTTCAACTCTTCCCTTTCAAAGATGAGTTTGTTTCTTGGGTTCAATTCTCCTTCCAAAGTTTTCTTGAAATTACACCGGAACTGACAGATGAGAACTTTCTGCGGTGGCCACACGGGCGGCGCCCACTGCACAGTGGCCTCCAGGGTTGCTTCCTCAGAAATATCCACTTGAGAGAAGATCTGGGGTGTGTCTGGCTTCATTTGGGTCTCCAGGTTCACACGCCGACTGACCCATGTTCAACTGCTGTTCACATGGAACCCTTCTCCACTTCGGCCTTCAAAGTTCTCGTTTGAATATTTGCTACTACCACCAAGATCTGCACCTGCGGCGGCTCCACCCGGGCACCTCTGTGGTCCTCTGTCTCTGTGAACCTGGAGACCCAAATGAAGCCAGACACACCCCAGATCTTCTCTCAAGTGGATATTTCTGAGGAAGCAACCCTGGAGGCACTGTGCAGTGGGCGCCGCCCGTGTGGCCACCGCAGAAAGTTCTCATCTGTCAGTTCCGGAAAGAACGTGTCGGTCAAAGATGTTAGACGAGGCAATGTTGCTGGTGACAGCAAAAACGACCCACCAATGGAAGCAGCTGGCTTCACTGCTCAGGTGATTATCCTGAACCATCCAGCCA	365	375	534	544	10
2S43D:00536:03927	CATACATCCCCCATTGATGTGATCATCTTGGCCAGCGACGGCTACTACGCCATGGTGGGACAGGTTCACGGGGGCCTTATGGGTGAGTGGTTTAGTCCAGGCACTTCTTTACTGTTCTAAAACAATAGTATAGATTTGGATATGAAGCAAGATTGTAGTCAACTGGTAGAAAGAATAAATGTCTTCAAAACAGCCTTTAGTGAAAGTGAAGATGGATGAGAGCAGACCAGCAGTTGACATTTAATTCGAAAATTAATAGCTGTACTAGAATCAATTGAAATATGCTGTCCAAGCCAAGTATGGAGATTATAATAAAGAGATTCACAAACCAGGCTATCTGGCTAATGACAGACTCTTACCACAGCGTGTTTTGGAACAACACAAAACTGACCAAAGAGCAGTGGGAGGAGAGAATACAGAACATGGCGATGAGGTGCAAATCGGTAGTTATCTCTCAAGTTGCTGGCTGCTTTTAGGAATTCAGAGTGCCCATCACTGAATAAATCCCATGAAAAAACCCACCACTACGAGGCATCTTTATCACTAATGTAACTTCTTAAATTCTTCCTCAGTCCTGAGAGGAACTGAAGCTGGAGTGCCAGCTTTATATACAAAAAAGCTCTTTTGCCAGGTG	568	578	421	431	10
2S43D:09124:06919	CCCCCCCTTTTTTTTCATTTTTATTAGGTATTTCGCTCATTTACATTTGCAATGCTATACCAAAAGTCCCCATAGCCACCACTCCAAGCACACCCTCTGCCTGGACAAGCAGGCTTCATACTTCTACCCTCAGGGAATCCCCCTGCTTCTTATTTCGACTCAAGGCTCTTCCTAGAGAGACCCAAGACCAGTCCAACCCGCCATGCCCCGAGAGTCACCGCCAGCCATCAGACCAGACTGACTAACAATAGGATGGGAATAATCTTTTCTGGATGGATGGATGGAACAAAATCAATAAGAACAAAGAAATTGGAATATTTTCCAGAAATAAAAGATTTCTGTATGATTCCTATTACCAAGGACTGTGTTCAAAAGGAAAACTGAGA	612	623	263	274	11
2S43D:01255:04333	GGGAGTTGCTGTTGAAGTCGCAGGAGACAACCTGGTCCTCAGTGTAGCCCAAGATGCCCTTCAGTGGCCCTCAGATGCCTGCTTCACCACCTTCTTGATGTCATCATACTTCGG	574	585	73	84	11
2G5Z3:07563:11609	GCTGCGTTTGCCACTGATGTTGTGAAGACGTTATCTGCAGAGGACCCCACGTTGGCCACAGTCACTGTGGTCACTTCTTTCTCCCTTTGCAAAGAAGCTGCAAGTCCCATAGGTCTAGGACACCTCCTTGTCGATCAAGACATGGCAGACTCCAGACTGAAAGCCGCCTACATGAACAAAGAGAGAAGCAGCCCAGATCGTAGGAGAAGGACGCCATGAAGTATGAGCAGATGAAACGTGATGCGGAGATAAGAAAGGATCAATGATGGACGGAGCACGATAGGCGTGCGTGAA	460	471	126	137	11
2G5Z3:07823:12925	TGACGCATATGATCATCGACTGCTCCACTAAAGA	623	633	12	22	10
2S43D:08957:08747	GAGCAAGGCAAAGTTTGAGAATCTCTGCAAGCTCATGAAGGAGATCTTGGACAAGAAGGTTGAAAAGGTGACAATCTCCAATAGGCTTGTGTCTTCACCCTGCTGCATTGTGACGACGGGGTCAAGCTGGCTCAAGGCGGGTGACTGAGGTCACGTGGGGTCATCTAGGGTCAGCACGA	524	535	128	139	11
2S43D:03317:07579	CCCTGCTCCCTACCAAAGTGTACAATTCGGTGTTCCGTCCACTCTGGGCAGCCCTCACTGCCCAGCGTGGAAGGGAACAACGAAGCGATGCTGCCAGGCGCGTCTGTGCCCACTGGGCTAAGCCGGATGGTACAACAGACAGCCAA	81	91	131	141	10
2S43D:08249:12291	GGCAGGAACAAAGATTTCTCCCTAACGCCTTTCTAAAAGCTCAGGTAAGGGGACCCAAAAACCAGTACAGGTGGCAGCGTGCTAGTGGCAATCTTGGCAGAAGAGAACCCGTTGAGAAGGGAAGACACTTGGTGTTCTACTGGTTGGCCCCCAATTCAGGTTAAGATAAGTAGGTTGGCTACTAGGATTCAGTACAAAATTTGTGTGATTGGGCGGAATATTAGGCTTCGTTGCTTTGAGGTATGAAGGAAAGGTATTAGGGCTAAAATTAGGATAGATAAGATTAAGGCTAGGACAGGTGGGTCAGGGCTGCTGGGGGAGCCACGGGGATACTATACAGAGGGCAGGGCTTCTTCCAGGAGGCTTTAATCCACCTCTTCCATGCGCGAGGCATCCTCATCGCCTTCCAGAGGGGGGATCTCATCAGGAACAGCAGCACTGGGCTCCTCTGCAGTGACCTCATCTTCATCGAATGCCCAGGCCTAGTTTAATCATCTCCACTTCGGCCTTCAAAGTTCTCGTTTGAATATTTTGCTACTACCACCAAGATCTGCACCTGCGGCGGCTCCACCCGGGA	365	375	557	567	10
2G5Z3:06068:13168	CCCCCCCCTTTGTTTGTTTTTTGTTTTGTTTTAAAGAAAGGTCTCACATAAGAGCCCAAACTGGCCTTGAACTCAGTTCTTCTACCTCAGCATACAGAGTTCTGGAGGGGCGCAGGTGGCAGGACCTTCACAGTTGGCAGGTGAGCATCGTGGGGTGCAGGCGTGGGCGGCCTGGAGCCCTCCCGCCCTCCTCCGGGCACTTGCTTTCAATAGCGGCAAAGAAAAACAAAACAAAACAAAGCCAAGTGGGCAGGGCAGGGGAAGGGACAGGGACGAAAAGGAGACAGGCCATCGTAGCGCCCTCCAGCAGCTATGCTGCCCACACCCAGGGGCTCTTCCCCAGCTTGGGTTGGCATCTGTAGCAGCACTGCCTCATAGATGACCCCAGTATAG	267	277	258	268	10
2G5Z3:05291:03840	GGCGATTTCTCCAAGAACAGGCTGTTAGCACCGCCTCCGAACACCTGGGACACATCAAGCTGCTGCTGTGCAAGTGCTGGCTCCACCGCTGCCGAAGGGGGCCGTGGTGCTGGGTGCTCGGGCCTTCCACCCCATCGAAGAAGAGGCTGGGGTGGTTAGAATACGACAGATGCTCCTGTACCTATCTGGGTGAGGTGGTGGAGTGTGGGACGGTCATGTCTTGATGTCCAGCAGGGGCATCCGCTTGTGCTGGTAGCGGCAGGATCTCATTTGCACATTTCCTAAGGGGTCCTGAATCTGCTCACAAAGAAGCATGTGGGGCAGGATTCCTCAAGTCGACCCCGTGGGTGAACACGCACCCAGGGGTGGGGGTCCAGTGCTCAGTTGGCCCGTACTTTCTTCCCCCTTTGTCTAAGTAATTTGTGGCTTTCCTTTTTAGCTGACCCATGTTGTTGTGCTGTCTTGAGAACATCTAATTCCGCCTCAAGTAAATAAGACTCCAAAATCAGCCAACATCAATCATTCTTACCTAAAGAATAATAAATAAACGTTAGTATAAAAGACAAGGGTATAATATTTATTATTGATAACACAAAAGGTCAAACACTGGGACTTGGGAATACCAGTTTTTCAGATCCGTTTACAGGTGGTGGTCGCTATGTTCCAGGAACTTCAGGACCTTCCAACA	302	313	257	268	11
2G5Z3:05271:10272	GTTAGCCTATCAAGAAGTCCCTAGTAAAGAGCAGCCTGATGGATGCACTAGCCAGCCCTTTTAGAGAGCCTTGAAACCTGCTTCCGTACGCCACATTTCCCACGCCGCGACGCGCGGCGGGGATTCGGCGCTGGGCTCTTCCCTGTTCACTCGCCGTTACTGAGGGAATCCTGGTTAGTTTCTTTTCCTCCGCTGACTAATATGCTTAAATTCAGCGGGTCGCCACGAGGGCCGATCACTTCGTGGCTTTGGCACAGGGAATTCTCCATGTATTGAACCAACAGAAAGTGGAATGTATGGGTCTTATTAAAGGTAGTTTTCTGCTGTTTTGCCTGTATAATTACAACCCTGGAGTAATCTGAAGCGGGAAGCTGCCGAGGTTACCAGAAAGGTGGAGGAGACATGATATTCGTCATGCAGGAGGTGGAGAACCGTGTCCCAGCAGTACCTGCCA	260	273	358	371	13
2G5Z3:07757:07308	GGGCAATTAGCAGTGGAATAGAACCGATTAGGGTAGTAAAATAAGGAAAGTAAAATACCCTCGCGTTTAGGCGTTTCAGTTTGGTTCCCTCATCGGGTAATAATAATAAGTGTTGATTGCTCACGAACCAACCAGGAGCTGCAAGAGATCAACAGAGTGTACAAGGAAATGTACAAGACTGATCTGGAGAAGGACATCATCTCTGACACATCTGGAGACTCCGAAAGCTGATGGTCGCCCTTGCAAAGGGCAGGACGAGCAGAGGATGGCTCAGTTATTGACTACGAGCTGATTGACCCCAGACTCTCCAGCACCCAGCAGCAGCAGGCGGTGCGTGGCCCGGTAGACCTGCTTGTCCTTCTGCAGCTGCTTCTCGATCTTTTTGTTGGCCTCGCGCTGCGCCTTCTCCTCGTTGCGCTGGTCCTCGGTCTTACACCTCTTTTATTTTAAAATTGATATGTATATACAACTCGTGTGTCTACATCTAATCCTACTGTGAAATATGTTGGTGGGCTCATACAATAAAGCCTAGCAAAAGCCCGAATAGACAAGTTATTTACATCCCCTATCACTAGATAAAAGAGAGGAAAGGAGAGAGAGGGAAGAAAAGAGATCCCTGAAGAAAGCCAGGAGTCAGAAAGGAGGCAAGGTTATCATTAGCATACTTCCTGCTGATTGA	186	196	249	259	10
2S43D:07274:10096	CAGCAGGGTTACTGCAGTCATCCCATGCTTCCCTTATGCCCGCCAAGATAAGAAGGATAAGAGCCGGGCTCCAATCTCGCTAGCTTGTTGTCAAATTATGACTATCTGTAGCAGGTGGCGGATCATATTATCACCATGGATCTACATGCATCTCAAATTCAGACTGAGGTAAGGACTGAGTTACAGAGTTTCATTGAACAGGGAGGTTGGGAGTAAGAAAAAGAGAGAACTTTGTTGTCATGGAAAAGGATTGGAATTTGGCAAATGGCTGATGGTTTGGAGGTGTGCTCTTGGAGAGGTTGTACAACCCTCTGTGACAGGGGAACTTGATAAAG	352	362	264	274	10
2G5Z3:05499:01306	GACCAGAGAAGCTGAAGAGAAAGAAAAAGAGGGCATTAGTAAAACAAGAACATCGCTTGGGTGATTGTCCAGATCATCCTGATCGACAAGACCGGCTTCCATCCGAGTACGTGCTCGCTCGATGCGATGTTTCGCTTGGTGGTCGAATGGGCAGGTAGCCGGATCAAGCGTATACAGCCGCCGCATTGCATCAGCCATGATGGATACTTTCTCGGCAGGAGCAAGGTGAGATGACAGGAGAATCCTGCCCCGGCACTTCGCCA	45	55	53	63	10
2G5Z3:08275:05566	GCCACAAATTAGTTGGAGAAAATCTTTAAACTGATCTGTAATCTCATCTCCAATGGGATTTTTCACTATTCAGCCAGCCTGGCCTACATCTTTTTGTCCTTGTCTTTTCTTCCCGTAGCAATTTAACCTAGGATTTTATTATTTTAGCTAACATCTAGCTATCAGTTACTCATTCATGATCAGGATGAGCCTACAAACATCCAAATACTCATCAATTGGGAGCTTTAGAGCCGTAGCCAACAATTCATATAAGTAACCATAC	466	477	177	188	11
2S43D:09939:04858	GCCAATGTAGCTCTACTCTTTATAAATAAGTGTTAGGTAATTGAGAAGACCATCCATCATGAAGTGTGGGATATGAATACATTCCAGAGCATAGCCTTTTGTAATTTTAGGTAGTTATCAGTTCTCCACTAGCTCCATGTTCTAGCTTTTTCCTCCCACAGGACCTTGGGTAAACCAAGATATTCTGGTTACATTGATGCTCCGCTGCCTCACCCTGTCCCACCCCACACACCCCAGGCTCAAGCCTTGATGATTCAGTGACTGTACTGGGTGGGAGCCAGAAACCTGACCATTTTGTTGTCTACATGAGCCTAGACTAGCCCTGTGCAACGAGACACACCCAGGAGGAGCTGAAGGTTCCTAGGGTCCCCTGGGACCTAAAAGGAGCTGGGCTTTTCCTGAGCTGGGGGGATATGGAGAACACATGGGGGGATGGTCAGGGGCTCAGCTGCAGCAGAGCCAACAGCTAAGCAGGAGTCCAAGGCCCAGTAGTGGGATACTGGA	521	532	233	244	11
2S43D:01707:13039	GTGATAGTGATCCAGAGCTGGTGCAATGGAAAAAGGAGCTGCGTGATGCCTACCGCGAGGCCCAGCAGCTGGTACGCGAGTACCCAAGATGAAGAACAAGCCACGCTCGCCTGTGGTGGAGCTGAGCAAGGTGCCGCTGATCCAGCGTGGCAGTGCCAACGGCCATCTCGATCGGGAATTTGATCTTGGAGTCGTGGAACTGCTTGACAGCTGGCCGGCGGCACTTGCCAGCTGCAATCTCTTCCACCTTCATGATCTGGATGGAGTGGGCACGGGGCATGGTGTCGGGCACCATGTCTCGGTAGCACTGTGTGACACTCAGAAGAACTCGTCAAGAAGGCGATAGAAGGCGATGCGCTGCGAATCGGGAGCGGCGATACCGTAAAGCACGAGGAAGCGGTCAGCCCATTCGCCGCCAAGCTCTTCAGCAATATCACGGGTAGA	473	483	251	261	10
2S43D:09858:13844	CTTCTTGATGCTCTCCAGCATGTCATAAGGGCTGTAGCTCTTGTACCTTCGAACACTTTCTGGAGGTGCACACACTGCGCTCAGTCATGATGCTGATCCGCTTGGGACCATTTTTAATCCAGTATTCATAAACTTCTCTAATTAACTGTCATCTATCTTCTTTTAGAAGTAGTTTGGCTTCCTGCAGACATGACTGGCTGCTGACCGCTGCTTTTTCTGCTGACCCCAAATCATAAAATTTTTCGTTGCTACTTTCTCAGCTGTAATTTTGCTGTGTTTTCTGATGATCTTAGAGGAAATGCGATGATCAACCCACAAGGGTTGAAAACCTTAGACAAGTA	274	285	191	202	11
2S43D:01173:09721	GGAGACGATGATGGTGAGTGCCAGAAGATACGGGCTGGTTCCAGCAGAGCAACCTTCACTGAATCCTGCTCCTCATCCGATTGCTCATACAGCTCGTCACCTAAGAAGTTCCAGGGTGACTTGGTACTCTGTGCAGCATAGGAGTTGCCAGCGCCATAGTGACAGCGGGCAGGACGGGGATAGACACCCAGAGCAGAGAGTCCTCAGACACTCAAACACAGTATGAGGCCAACAGACCAAAGTACAGTTTCCAGGGGCTGCAGATGTGCTGCAGACTGCAGTCTGAGGTGGAGAGGCAGGGGCAAAAGGAGGGTTTGGAGCAACTGACTGGGGAGATAGGGTGGTGGGCAGCATTTCAGGCTTGAGGGTTGATGA	51	62	286	297	11
2G5Z3:02634:01900	GTCACTTTTCCTTTTGTAGATGTACTGCTCCATCTGAAAGTCAAGGTTGGTGCCACCTAAGTGGGTTCCCGCAGCAAGGAATTTGAGGACATCCTCCTCCTTCATCTGCAGGACGTCAAGGGCTCCGGACATTGTGTAAGTTTCCCTTAAGTTACGATGGGAATCAAGAACAACGCCGTATGGACCCGTCCCCGA	184	194	105	115	10
2G5Z3:00154:05246	AGAAAACTTTATTCATGAGGTGGCTTCTCTGTGTGAGGATTTGCAGTCTTCTCCCAGGGTCCCGGCTAGCTCTTTTCCATGAAGGCCAAAGAGTCAATAAGGCTGTCATACCAAGCAACTGACAAAGACAGTGGCTGGAAGGCCACTGTCCAAGGCCCAGTCCAAGAAGAGTACATGGTGGTGTGGGAGTTCTTGGTTCTTCAGCCACCTCTGTGAGTGAGCTTGGGTTCGTGGGTGTGAGTCTCTGTGTTAGACACTTTCAACAATGCTTAGCATTAATCCAAACTCTTCCCATTAGAATATAGTTTCTTCAACCCTCGCTCTCCTCCCAATCACGGCCTATCAAATAGTGGGTGTTACAGCTGAGGGCCAGACTCCACCCAGTGACAAAACCAGTAGAGTCCATGGACTGGGCTTTTGTCTTGTTTCTATTATCTGAAGGGCATCTTGGGCTACACTGAGGACCAGGTTGTCTCCTGCGACTTCAACAGCAACTCCCACTCTTCCACCTTCGATGCCGGGGCTGGCATTGCTCTCAATGACACCCGAATCTCAGTGAGGCCTCCTTGGTGAACACGAAGCCCACGTTCCCCCGGATGTGAGGCAGCAGTTTCTCCAGAGCTGGGTTGTTCTCCAGGTGGCCCCTGCTTAGCCTTGCGCGATCATGGTGTTCTTGCCCTCAGCACCACGGCCTGTCAGATTCCCCCAAACGGCACGTGAACCTGAGTGCGGATACTGCAATTTTCAGAGGGAAGAATGGCAGCTCTTATGGGTGGGGGACGGGAACTGTCACTCATTTTGCACAACTTCTTAAGCGGCTGATCATTGAAAGCCATGTATCTTGCAGGGAGACGTGGCCATCCCTGTTGGGATCAACAGTGTCCAGAACTTGCCTCAAACTCAGGATCCAGGCTCTCCTTCCTCAACATTGGCAGATCATAGCCCAGGGAGCGAAGACAGGATTGAACTCCTGACTGGTTCAGCCGGCCAGACTTGTCTTGTCGAAGTGTTTGAACATCATGCTCCTCGTTCACCGCGCCCCTTCCAGCCCGCGACGCGCCGCGACCAGAAAAAACACGGCGGCCGCCCGACACAA	458	468	995	1005	10
2S43D:07375:09082	TTGGTCTACAAGACGCCACATCCCTATTATAGAAGAGCTAATAAATTTCCATGATCACACACTAATAATTGTTTCCTAATTAGCTCTTAGTCCTCTATACTCATCTCGCTAATATTAACAACAAAACTAACAACAATACAAGCACAATAAGATGCAACAAGAAGTGAAACATCATCTCCTGCCCCATACAACTGGACAACTGAGCCACACTGGGCAGGTCCTTCCCTGGGGCCAGGTTCCCTGTGTGAGTCCCCTGTCCTTCACCCTCTCTGCTGTATGGGTCACTAACTCGGACTCCAAGGAACAGAGCCACAGAGCATGTCCAAGCTGCTCTTCCTGTCATCCTTGCCCTCTGGCCAG	311	321	334	344	10
2S43D:07341:10836	GGAGAGGAGAGGAGAGGAGAGGGGAGGGGCTAGCCTGGCTTGCAAGCCTTGGGAATGCTTTAGCATCTGTGTTATCACTGCAGACAAAGAGCTTCGGTGGATGAAGGTGGTGCAGGGAGCAGGGCACCCACCCCAAGTTCCAGAAGCCCAAGCAACTAGAAGGAACAAGGACCTGATTTTCTGGCCATTTATCCCCGCGTCCGAGATGCCGCCGCAGAAGCTGAGGTTGAGGAGCCGGAGGCCCGTCAGCCCTCGCGAGATGTGCTTCAGGGAAAGATCCGTGAGTTTCTGGCAGTCCTGAAGAGTGAGCTGCTCCAGGCA	103	113	204	214	10
2S43D:02690:09539	TTAAGAACTAAAGTTGTGATGAATAATTGCTCCTGACTTGCAATGTTCTCTCTTCCTCCCTCGGCTTTATATTTTTAATTAGTTTTGAGTGTATAATATACTCATCTCAATTCTGGAGTTGAATATGATAAATTCCAAGATCTGTCTATGAGCCATGCTTTTGTAGGGGTGGTGCTATTTTCAGCATTCTGAGGACTGCTTATTTAATAACTGGGCCTTCTGGGCTCTCAAAGGGGTATCTCATCAGGATGAACGCATCTGACTTAAATCCTTGTACCCCATTCCAATGGGCCGATGGGCGTTTATTTTGATAAGATGTGCCTCTTGGAATAAGGGTAGTAGTTTATATCAATTATTTATTCAGATTTCGGACAATGACTTTAGTGACA	467	477	242	252	10
2G5Z3:06899:14354	GGCTGGAATCCTGTGGGAAGGGAAGGTGAGGGGGTCAGAGGCTCCTGGCTGGCAGTCAGGAACTCTTCTGCCGCTTGTGCGCTCTATGCTTGATTGGTGTGACTGTCTGCGCGTCTGCTGGCCTGTACTTGTGGGCAAGCTTAAGCAGCTGAGTAGCTGTCTGCCTGTCCAGGCCTGGGTGAACTGGTTAATGGCAGGAGGACTTGAGCCGCTTGTAGAGATAGCTCTTGTCGCTGCAGTCTGATGAGCGGGTCATTGACGAGCGCGTTAATCTCTTTGGGCTGGATCGAATTCCTAAGAGTCGAGGTGTGGGACCCACCGATCTGCCAGGGTGCCTTTGGAAATATGTGTCGTGGGGGACGCAATTGTTTGCACCAACCAAAACCTGGCGTCGTTGGCCACCCTGAAACTGAACCCCATGAGGGAAAGAGGAAAGTGGAATCTCTGTGGCCCATCTTCAGGATCCATCACCAGAAAACCCGCTATATCTTCGACCTCTTTTACAAGAGGAAAGCCATAAGCAGAGAACAGAGCAGAACTTATTACACAGAGCAGCACTTCTTACACAGAGCAGAACTTATTACACAGAGCAGAACTTATTACACAGAGCAGCATCTTCTTACACAGAAGCACTCGGTCTCAGGACAGCACCCTCTAGCCTGTTCACCGAACTTTGACTCCCAAATCAATGTGCCGAAAACCATGGAATTCATGGAACGTTTTCTCAGGTGACCATTGGTTTTATTCCAGGCATGGAAGTATTTGAATTTTCTAAAAAGTTAAACCAATGAAATCATATCGTATATGATGCTTAATTCATATATTCCTGCCGAGCGGCGGCAGTGACCGGTGGACGCTGACGGCGTGCGCGCGTCCGTCCGTCCGTCCAGCGGGGCGAGGGTCGGTGCACATACATCTTGACCGCGGCGGGTGAACATCTTGACCGCGGCGGCTCGTCCGTGTCTGCGTGGCGGGTGCGGGTCCTGCGGATGCGTGTGCCTGA	330	340	824	834	10
2G5Z3:07290:13235	CACGAGCATCATGGGTCACCAGGTGCGGGATTCCTTTTGTGCCTACAAAGATCTTTCTCACTTTGCACAACTTGTACTTGGCCTCCTCCGGTGTAATACGATGAACAGCAAAGCGACCCTTGGGTGTCATAGATCAGACGGAAGTTCTCTCCGGTCTTGTCAATGCTGATGACATCCATAAAACCCAGCAGGGTAGGTTATATCGGA	455	466	150	161	11
2G5Z3:05864:06711	GCCCTGGGGGTGGGGTGGGTGGGCGCCTGTGTCCTGGCTCCCCCTCCTGCAGGACGCCGTTCTCCACCTGGCAGCGGCCAGACACCTGGTAGCAGGTGCCAGGTTCCAGGTTCTGCATCTCAACAGGAGTCAGCCCATCTGTCTTCAGCTGGGGCTCCAGCCGGGTCCATGTTTCAGCCTGGCATTCCTTGTACCGGAACTGACAGATGAGAACTTTCTGCGGA	184	194	46	56	10
2S43D:04455:09560	TGAAGATAATGGTATCATCAAGGCCTTCCGCAACATCCCTGGTATTACTCTGCTTAATGTAAGCAAGCTGAACATTTTGAAACTGGCTCCTGGTGGGCATGTGGGCCGTTTCTGCATCTGGACGGAGAGTGCTTTCCGGAAGTTGGATGAGCTGTATGGCACTTGGCGGAAGGCTGCTTCCCTCAAGAGTAACTATAACCTGCCCATGCACAAGAATGATGAACACCGACACTTAGCATCATAGCTGCTTCATAGCAACCTTCATTGAATGGCGAAACAATGAGCTCTTCTGTGCTGCGGGGGTAAATTAGAAGCAGTACCAAGAGTCAGCTTGCCCTTGTTGACGTCATGGAAGACAAACTCAAGGGCGAGATGATGGATCTCCAGCATGGCAGCCTCTTCCTAAAACACCAAAAATTGTCTCCAGCAAAGACTACTGTGATAACTGCGAACTCCAAGCTCGGT	394	404	197	207	10
2G5Z3:06953:12363	GGAATGTGGGGTCAGCGGTCTGTCACTCTCCCTACACGCTGGCGGCCAGCCTCATCGAGTCAGGCATGAGCTGGAGCCAGGCGGTCGGCACGGTCTTTTTGGGCAACCTCATCGTGCTGCTGCCGATGCTGCTGATCGGCCATGCGGGA	2	12	133	143	10
2S43D:01117:10077	CAACCGTGCACGCCCAGATGCCGAGAAAAAAAGAAATGAAAACAATCACGGGGAAGACTTTTTCATCCCGCTAACTCTTGGGAACTGAGGAGGAAGCGCTGTCGACCGAAGGCTGGACTGCAGGGAAGTGGAAGGAGTGTGGACTGGGACCCTGCTTGCTGCACCTGGGAAGGCACACCAGTAAGAGATGGCTCCTCAGAATGTCCTTAGCTATGTCTATCCCATGGACCCCAACTCCAAGGGGCTGAGGGGAGAGGGGAGAACTAGAAGAGAACTAGGGAAACTA	333	343	18	28	10
2S43D:01083:05400	CAGGGGCTCGCGCCAGCCGAACTGTTCGCCAGGCTCAAGGCGCGCATGCCCGACGGCGATGATCTCGTCGTGACCCATGCGATGCCTGCTTGCCGAATATCATGGATGGCGTTGGACAGCATAGAACACAACACGTGGGACCTAACTTGCAAGGATTGGGTCTTCAACTTCAAGTGCAATGTGTATGAAAACCAATCTGAGCCTTTGTATTCTCGTAAATATTTATTTTGTAATTTTTGTGAAAATCCGGGGGAGAGGGTGTAAATCTCGCGCCGGGCCGTACCCTTATCCGCAGCAGGTCTCCAAGGTGAACAGCCTCTGGCATGTTGGAACAATGTAGGTAAGGGAAGTCGGCAAGCCGGATCCGTAACTTCGGGATAAGGATTGGCTCTAAGGGCTGGGTCGGTCGGGCTGGGGCGCGAAGCGGGACCAGATGCCAGTGCTCGCACGGCACAAACTCTGACCATTGAGCGCCCGGGGTGTGGAGAGTTGAGGATGGGAGGTGAGTCAAGGTACTAAAACACTCTTCTAAACACTTTACAAACCTTTTGAAAAACCCATAGAAATCTAAAAAAAAAAGGTACAATAAGAAGCCAAAATAGGTTCCCTAAAACATGTCCTTCCTTCCTTCTTCCTTCCTTTCTTCCTTTTCTTCCTTCCTTCTTCTCC	493	572	0	79	79
2S43D:01858:03544	GCGTCGGGGTCGGGGCGACGCCGGCCTCGCGGGCCGCCGGTGAAATACCACTACTCTCATCGTTTTTTCACTGACCCGGTGAGGCGGGGGGGCGAGCCCCGAGGGGCTCTCGCTTCTGGCGCAGAACTGAGATCACTCATGCTGTTGTCATCAAGAAACTGAATGAGATTCTACAGGTCAGAGGCAAGAAGGGAACAGACCGTGCCACTCAGATTGAATTGCTCCAGCTGACTGGTTCAGATTGGCTGCTGAAAATCGAACCTGGGGGTGGGCGTTCATTGTCAAGACCCGTGGCGCCGGCAAGATGGGCAAGTTGTCGTGTCTCCGAACTGCCCGGAGCTCCGCAGTCACCGACGGGAC	149	160	278	289	11
2G5Z3:09682:12716	GTGGGAGCACCTGGAGCGCAGAGCTCGGAAGGAGAATCCAACGAGTTGTAAGAAAATGGACAGACGAAGTCCCGGTACAATGGGGGAAAACTCGCCAGCGGGGAGAGACATGTTATAAAACATTGAGAGATATGACTGGGAGAGGGTTCCTGGATTCCTGTACTCATTAGCTGCTTTCAAAGTCGTCACAGTTTATCTTGGGAGTTCTCAAGTGCTGCCCCGCCCATAAAGATAAGATTAACCCGTGGGCCCCCCTGATAGTCCTGGGGATCTTAATAAGGGCAGGAGTATCAGTACCACATGACAGCCCTCATCAGTCTTCATGTACTTGGAGAGTTACCAACTTAATGACGGACAAACAGCTAATGCTACCTCCTCGGGGGGTTGGTTCTTTTTCAAGACAGGGTTTCTCTGTGTAGCCCTGGCTGGACTAGAACTCCCTTTGTAGAATAGCCTGGCCTCAAAATCACAGAGATCCACCAGCCTCTGCTTCCTA	70	80	130	140	10
2G5Z3:08013:07637	GATGGTGTCACTGGGCTCCACCTCCAAGGTGATGGTCTTGCCGGTCAGGGTCTTCACGAAGATCTGCATGCCACCTCTCAGGCGAAGGACCAGGTGCAGGGTTGACTCCTCTGGATGTTGTAATCAGAGAGGGTGCGGCCATCTTCCAGCTGCTTGCCGGCAAGATCAGCCTCTGC	579	589	149	159	10
2G5Z3:02874:02009	CAATGGTTGAGTCTCAATGGTGTCACCTTCCAGGATCATCACAGCCCTAATTTTAATATGAACTCAAACAACATATTTAAATTAGTTATTTTTCCATTCCCTCCTCCCTCGTCCAGCACCCCAATGCGAACAAGCCGCCGCAGGAGAGCATTGCCTCAAACAGACGCCGGGGATCCTCTCGTCTAGCGATCAACAGCGTCCCGGGCCGCCTTACGGATCTTGGCCAGGGTAAACTTGACCCTCCAAAGGCCAGCTTATTCTTCATGTCCTTGGCTATGTTTTTGCTCTTTCTCTTCCGGGAAGCTTCATCACATTCTGTGAGGTCAGTCCCACTCATCTTCTGTGTCCCGTGAAGAACAGGGAAAGGTGGTGCATGGAGCCTCCATTACGACCCAGTTCTTTTTGAGGTGCG	142	152	395	405	10
2G5Z3:02684:00861	CGCGGCAGCCGCAGCCATGAGCAGCAAAGTCTCACGCGACACCCTGTACGAGGCGGTGCGGGAAGTCCTGCACGGGAACCAGCGCAAGCGCCGCAAGTTTCTGGAGACGGTGGGAGCGCAGATCAGCCTGAAGAACTACGACCCTCAGAAGGACAACTTCGTCGGGACCGTCAGGCTCAAGTCCACCCCACGCCA	522	532	171	181	10
2G5Z3:07153:08668	GCATACACGGTACATGGGACCCACAAAATTTTTATCAGGTAAAACGATATTCCGGAGACCAGAAAGGACGCCAGTAGTGACCCATGGGGTAGGCAAGACCAACAACAACCAGATAGGCCATTTTAATAAGGGGTAAACGGGGACAGCGGTCTAGTTTTGGCTCATCCAGCTGACGCTGCAGCTTCTCCTGCTCCTTCATGTAGCCGCTCCTCTACTTCTTCCTTTCCCTAAGCAGTCTGTGCTCAACAGCCTTCGACCCTCCAAAGATCGGGCTACACACACACACACACAACACACACAACACACTTAACTTTTCTAAAACTGGCTTGGTGAGGGCTGGAAGAGAGGCTCTGAGCTTAGCCAGAATGAAGTTGGGGTCTCTCCAGTGTAGGCTGTCTTCGAAAAACATAGAGCAAAAACATTGGATGGGAAATAAAGGAACCAAAACAAATAGAAACGTTGTTGAGTTTCAGTGAAAATACTTAAACACATGCAAGGTCCTGACGGTTAGCCTTGGCCTTGGCAGGGGCTGCAGGTAGCCCTGGAGTTGGGACAGTATCTTAACTCAAGGCACT	562	573	76	87	11
2G5Z3:01458:04955	GGCGTCTGGAAGGACAGGGGCGAACTCCACTCGCCCCATGGATATCCGTTCTCCACCTGGCAGCGGCCAGACACCTGGTAGCAGGTGCCAGGTTCCAGGTTCTGCATCTCAACAGGAGTCAGCCCATCTGTCTTCAGCTGGGGCTCCAGCCGGGTCCATGTTTCAGCCTGGCATTCCTTGTACCGGAACTGACAGATGAGAACTTTCTGCGGTGGCCACACGGGCGGCGCCCACGTGCACAGTCGGCCATGGGCATCGAGCGGACGATGATCGGCTCAACAAGGTCATCAGTGAGCTGAATGGAAAAGAACATTGAGGATGTCATCGCTCAGGGTGTTGGCAAGCTGGCCAGTGTGCCTGCTGGTGGGGCTGTGGCTGTTTCTGCTGCCCCTGGCTCTGCAGCACCTGCTGCTGGTTCTGCCCCCGCTGCAGCAGA	425	435	252	262	10
2S43D:00629:02751	TGCAGAGTCGTGTTAACTAACCCCCACTCATTTGAGCCGTGAGCCCATTAGTCTTTGTTCACGGAAGTGAAAGCACCTGACCCTGCATCAGGCAGTGCTGGCTTGGGTTTTTGGCTTTTATTGTGAAACAGCCAGCCTGTGAGGAGCGCTTCCCCACAGCTCAGCATTCCCAGGCCTGACGCACTCCTGCTCCTGCCTGTAGATTTATGCTGGGAGAAGACACCTTGCCCCTCTCTCGGGTCAGGCTGAACTCATGCTGGATGGAGTTATCCTTGGTGTTATTCTCATGGCGGCAGTCCAGGCGAAGGTTTTGGTTCACCAGGCAGGCTGTCAGGCA	327	337	187	197	10
2S43D:01848:08640	GGCTCGCGCCAGCCGAACTGTTCGCCAGGCTCAAGCGCGCATGCCGACGGCGATGATCTCGTCGTGACCCATGGCGATGCCTGCTTGCCGAATATCATGA	542	598	43	99	56
2S43D:08833:04646	CAGGAAATGAGCTTGACAAAGTTGTCATTGAGAGCAATGCCAGCCCCGGCATCGAAGGTGGAAGAGTGGGAGTTGCTGTTGAAGTCGCAGGAGACAACCTGGTCCTCAGTGTAGCCCAAGATGCCCTTCAGTGGGCCCTCAGATGCCTGCTTCACCACA	574	585	141	152	11
2S43D:04248:03729	GGGCTGGAGAACTCACGGAGGATGAGGTGGAGCGAGTGATCACCATCATGCAGAACCCACGACAGTACAAGATCCCAGACTGGTTCCTGAACAGACAGAAGGATGTGAAGGATGGGAAGTACAGCCAGGTTCTGGCCAACGGTCTAGACAACAAGCTGCGTGAGGACCTGGAGAGGCTGAAGAAAATTCGAGCCATAGAGCTGCGCGTCATTTCATAGCACGAACAAAGGCAGGGCAGTAAAAAGCAAAGACGGAAGAGGCAGCATCTCCAGGGAAAGAACAGCCTAGGTCTCAAGCCACCCAACCTTCTCTCAAAGGTCACTTGCTAGTTTCAGCCAGTGTAGCGTGGGTACTGTGCATGACCACATTTATGTATGGAATCACACAGACCAGAAAGAGGATTCTCCACTGTAGACAGTTCTGACACACCGGCCTCACCCCATTGATGTTAGTGGGGTCTCGCTCCTGGAAGATGGTGATGGGCTTCCCGTTGATGACAAGCTTCCCATTCTCGGCCTTGACTGTGCCGTTGAATTT	53	63	168	178	10
2G5Z3:06548:02506	AGACATCATGCTGGCCACGGGCAAGCTGTCCCCTGATGCCATTCCAGGTAAATGGGCCAGCCGAGACTGCCAGTGCTGGCGG	213	223	9	19	10
2S43D:08936:09871	GGGGCACAGGAGGTCCTCAAGGGTATGAATAGTGTTACTTCATTCAGAGTGTTACTTTGTTTCTCTCCCAATCGTTTGGAGACCCTGCAACATTTACCTAACATTACCAAAGCCTGTCAAATCAATTCTTCAGTTCAAATTTTTGTATCCAATCACAACGGGGAGCATGGGGCCTGCTAATCAGAGTCTGAAAGCACGATGATCTCCTCCGGGTCGCACTGTGTGGCCACACTGGTCTTATAAATACACTGCCGGAGTCTCGAGGAAGGGGACACCCAGAGAGTCTGACAAATTCCTTGGCCGTGGTGTTGTCCACGACCTTCTTGGTGGTGAGGTCACTCTTGTTGCCTACCAGGAGTTTATTGACATTCTCACTGGCGTAGCGATCTATCTCCTGCAGCCATCTGTTTTCACGTTTGGCGTACGGAACTCCCTGGTCAGTGACGTCATACACACAATGATGCATGAGCCCCGCGATATAGCTGGAAGTGATGAAACATACTCCAACGGTTTCCTGGTCCCTTGTTTCCAGGTCACCTTTATCCCTGGGCTCCCATCAGCACTGCTCACTCCCACGTCACAGGGGGCAGATTCTGGAGCCAAGCACACCAGAGACAGGTTGGTGGGAGGCACCCAGCTGGTGCTGTTGCCAGGAGAGACAGCCATTCTTATTCTACTGAGACTGCCAAGGCACACAGGGGATAG	549	559	196	206	10
2S43D:07032:04848	ACCACCGCCGTGTCCCGGCCCGGCCTCGGGGAGCCCGGTTCATCATTGTCGGCTACGTGGACGACACGCAGTTCGTGCGCTTCGACAGCGAACGGCGGAAAATCCGAAGGAGTGGAGCCTTCGGGGCGCGGCGCACTACTTGTAAAAGCCAAGGACAGGATCTCCCTAAGGATCCAAGTACCCATGTTTGAAGTATACTTTCTTCTAGTTGACCAGCCTGGGCAAAGCAGGACTGAGGTAGCTTACACCAGCCTTTTTAGACAACCTTGTTTAGC	304	314	155	165	10
2G5Z3:02261:05632	GTTGTTTTGAGACAGTTTTCACTCTGTGGCCCTGCTTGCCTCTGCCTCCCAAGTGCTGGGGAATTAAAAGGTCATTAACCCTACCACCGCAAAAAAACCTTGATTCGATGCTAGAAGTAACTTGATCAATGAG	578	588	30	40	10
2S43D:09404:12773	TCTCACTAGCCCTTGTCAAGACTTTGGCAAACGGATGTTCAGTGTTAAAAATCACTACAATACCAAACAGCAGGACCAACTTCTTCCAGGCAGCCCTTCCTGGAGGAGAGAGAC	149	159	12	22	10
2G5Z3:06282:08172	TGCTTTTGAGACAGTGTATCCTCTGTAGCCCAGGGCAGCCCAAACTTCTAGCTATCTGGAAAAGACCTTGAACTTCCTTCTGCTCCTTCAGTCTCTCCCTCCTGAAGCTAGAATTCAGGTGTGAGCCATCATCAGATCTTATCTCATGCTAGAGAAGTCGCGTCATACGTTCTAACTGAAAGGCTTTTTCTGGGGAAAGGTAACTCGGGCCCACGGAAACAGCGGTATGGTTCGTGCCAAATTCCGAAGCAACCTTCCTGCAAAGGCCATTGGACACAGAATCCGTGTGATGCTGTACCCATCCCGGATTTAAACTAATGGAGAGACGGAGACAGACTGACCCGGGCAGCCAAGGTGTTGGAGCAGCTCACAGGCCAGACCCCGGTGTTCTCCAAAGCTAGATACACTGTCAGGTCCTTTGGCATCCGGAGAAATGAGAAGATTGCTGTTCACTGCACAGTCCGCGGACCAAGGCAGAGAGGTGGCTATTTTGTGCCTGCAGTTCCGCAGGCTCAGGGAAGACCCCCATATTACACGCCTAACCAGTTAGCACAGATGAGCCTAATCCACGCTGGCAGCAAGGCGGGAGACCTCAAGGCTTCCAAGGAATGCCAGGGTATCTGGGAGCATGAAAACAAAGGACTGGTAGTCAAGTCCTGTGATCAAGCTGTCAGTCTATCGCTCTGCAGGACGACAGCTTCTGTCACTGTTCTCATCTGACCTGCAGCACGGGCCACTCCAAGTGGGTTTCCCAGCCCGGCTTCCATGGGCGCGTAAAAGCAGAGTGTGCTTACTTGGTTGGGAAGCTGGCTAGCGGGCTCATCCAGAGATTGGAGACAAATTCAGCAGTCGCCATGGACAAAAGGGTGTCTGTGGCCTGATCGTCCCCCCAGGAAGACATGCCGTTCTAGTGATTCTGGCATCTGTCCCGACATCATAATGAACCCACACGGCTTCCCATCAAGAATGACGGTTGGAAAGTTTAATTGAGCTGCTGGCTGGGCAAGGCAGGCGTGTTTAGACGGCAGGTCCACTACGGCACTGCCTTTGAAA	184	195	683	694	11
2G5Z3:09572:02175	CTCCAAAGTGGCATCTGCTGTGTTTTCTTCTGTGCACAGTGTGCATCTGTCTCTGTGGCCTTCAACTTCATCCTCGAGGTGAAGGCCAGGAGCTGTGACTGGGCATAGCCCGGCTCCTCTGCAGTGACGCTTGCACTGCCGCTTCCTTCCTCTTCAGAACCCAGCTTGGTCACCACATACTCAGCCCGGCTCGGGGAAGATGAGAGAGCTTGGGGACCACGGCTCCAGCTCCGAGCCTTGGACACACGCAGACTGTCGTGCTGCTCAGGCTCGGGGCTTGGGCTCGGGCTCGGGCCCTCAGTGGCTACACTCTGAT	72	82	95	105	10
2S43D:05056:08567	TAGCCCTATCCATAAAACTAGGCCTCGCCCCCATTCCACTTCTGATTACCAGAAGTAACTCCAAGGGATCCCACTGCACAGTAGGACTTATTCTTCTTTACATGACAAAAAAATTGCTCCCCTACTCAATTTTAAATTCAAATTTACCCGCTACTCAACTCTACTATCATTTTAATACTAGCAATTACTTCTATTTTCATAGGGCATGAGGAGGACTTAACCAAAAAGGACACTGGATCTCCACCAGATAGATAGGCTCCATGAGCGGGGCTGTGCGGTCAGCACACTGGGCATACAGGCAGCGCGTGCTGTGGGCAAGAACCAAGAAAAGTTAATTAATAATCCACCAGTCCAGCCTAAACATTCCTACTTCCATACCTGTTTACATGGAATTATATCCAAGTAAACTAAGACAAGAAAACATAAAACAGAAAGTATAGGCTTGCCGCCGGTCGCAGACGATCGAGGGCCTCGAAGAGCAGGTGACCGAGATCCTGGGCGAGCGCGGACACCGCGAACTCCGACGACTGCTGTCGAACTGCTGGACGTTACGAATACTTAGCAGTCCGGCTTACAGCTAACATTACTGCAGGACACTTATTAATACACCTAATCGGAGGAGCTACTCTAGTATTAATAAATATTAGCCCACCAACAGCTACCAGAGAGCTCCCGAGTAGATGCCAAGATCCGCAGCGCCTCTTCTTTGAACCTTTTCCCAACCATTAACCCTTTGTCCGTATGCTGAAGCAACTTCTCTAAAAAAGTTTCCTCGAAATGAAAACTGGGTGCTTGGGAGGGATGGTTGGGTCCTAGGAAAAAAAAAAACTCAAGCCTCGACCGGATGGCCCCAATTAACGCCGGAAGGCCGTTCCCATTGGCAGGTGCATCTCTCCATTCTCGAAGAGAAAAAGATCCGGCTCCGGTTGCAGATGGAAGTGAACGACATAAAAGAAAGCTCTTCTAATTCAAATGATTAGCTTGATAATTGAGACATCACAATTTATTCATCCTGTGTCCAAAGACTCAGATATTCTGCCCATGA	183	193	585	595	10
2G5Z3:07093:14058	GAGAGATAAGGTTTCCTCCAAGAACTCACTGGAGTCTATGCCTTCAACATGAAGCAACTGTGGAAGATGAGAACTTCAGGCAATCATATGGCTGCACATCAATCTCATTCCCAGCAAACAGGACCGAACCCTGACCATTGTGGATACCGGGATTGGAATGACCAAGGCCGACTTGATCAATAACCTTGGCACCATTGCCAAGTCGGGCACCAAAGCCTCATGGAGGCTTTGCAGGCTGGTGCAGATATCTCTATGTTGCCAGTTTGGTGTTGGTTTTTACTCTTGCCTATTTGGTTGCTGTAGAAAGTGACTGTCATCACGAAGCATAACGACGATGAGCAGTATGCAAAGATAGCCGGCTATGTCACGCATCTGATGAAGCGGATTCAGAGAGGGCCTGTGAGAGGCATCTCTATCAAGTTGCAGGAAGAAGAGAGAGAGAGGAGAGACTAACTACGTTCCTGAGGCTGGGAGGAGAGGCGATGTTTAAACTCTGCTCTGCTAGAGTAAGCCAGTTTGATAAATTCTTGCAAAGGAATTTCTGGAATTCTGTTCGCCAGGCTTGAGGGCCCTCTTCAACTTTGACTTCTTCTCTTCCACCTTACTCTGACCGCAATGCCACCTTCTGTTCCAAGAGCGCATACACCTCACCCCGGCCCGGACACGGACAGGATTGACAGATTGATAGCTCTTCTCGATTCCGTTGGGTGGTGGTGCATGGCCGTTCTTAGTTGAGAGTCTGTTCCCATGCAAACCAATGAGGGAGAAGTAGAGGAAGAAAGCAGCTCCCAGGTGGAACAGGAGGATTTTGTAATGGAAGGGCATGGCAAGACTCCACCTCCTGGAGAAGAAAGCAAACAAGAGAAACTCATTCTGGTCACTACAGAAGGAATCGCACTCCATAGGTACTGATTCATTATTATCTTCACTGAAATGTTTCTCACTCTGGTCAACCTCTTTGTGAGGTAACTCTGCATGGATGGGATGTTCAACCAGAGACTCTGTCGTTTCTTCTAGGAATTTATCTGATTGGGAGTTGTCAAGATTATGTTTTAAA	514	528	549	563	14
2S43D:01932:02652	AAGATAAATACACAATTTACACCAAGGAGAAGACTGTGTGTTTAATACTTGATAACATTGATTTTGATTAATAAGGAAATAATGTAGCTGGCGATGCCATGGGGCCCCAGAAGTGAGGAGTCCCAGTACTCAAGAACACCCAGGCTCAACCAGTTACCTCACACTTGACCTTCTCCTCAGACTACGTGGGCAGCCCTATCACCTGCACCTGCTTCAGCCGGGACGGGCAGCTGCACTCTGATATCCACTGGACTCTACTCTTGCGGCTTCTAGACTAAAGACAGGGGAAGCTGCTGGGCGAGTATGTTGGCCATAAGAACCAGAGTACAAGCTGGACATCTCAGGTAGTAGATTCCCTTGCTCCTGAATAACCTGAGGTGGAGGCTGCAAAACAGCTAATGGCAAAGTCTCAGGCTGACAGAGAGGCTGGACGTGAGCT	324	335	355	366	11
2G5Z3:07252:13808	CTAAAGCTCCTGACCTCAGAGGGCCCCCTCTACCAAGCAGTGGCCAACTGCACCAGCTGCCGCCGTGACCTGACCAAGCCATTGCTCCAGCTTCAGGATCTAAGGAAGACGCAAGGGGTGGGGTTGGACTGATCCATCCAGCGTGGGGGCACTCTCTAGCCATTGAGGGTCCCAGGCGGTACCCCCCCTTTGTTTTCTTCTTATTGTCTTTTAAATTAATTATACTAGGAGCTAACAAGACTCATCAAGGTTAACAGCACTGGATGGCTCTTCTAGGATGACTGGGATTCAAGTTACTGGACAACCTCATGCCAGCCTACAACCACCTGGATTCCAAAAGACCATACTGACTCTATTTTGGTCAACCTCTCCCTGGTAGCCTCCTCAGCAGCCTCCACAAGGGCCCGGAGTTGTCCCAGCACTTCCTGCTTCTGGCCAGCAGGGACTTGAGGATTCGTTCAGCTGCCTCCTCCACCTGAGTCCCCACACTGGCTGCCTGCTCCCGTCATGACCCTATCAACTTCGATGGTAGTCGCCGTGCCATACCATGGCTG	105	115	57	67	10
2S43D:06834:07971	GACAAGGTTCAGAAAGGTAAAATATAAAGGAAGCATTTTGAAAAAAAAAATAAGAAAGAAAAAGAAAAAGAAATGTATTTGAAGCTTCTGCAAGTCTGAGAAAAAAAAAACAAAAAAGAAAAACAAAAAAAAGGGGGGGGAAACAGGTCTGTGATGCCCTTAGATGTCCGGGGCTGCACGCGCCGCTACACTGACCTGGCTCAGCGTGTGCCTACTACGCCGCAGGCGCGGGTAACCCGCCCAGTAGAGGTCCAAAAGTGGCCGGCTGAAGATGAGGCTGTCCTTTCCTATCCAGAGCAGTGATGATGAGCAGGTAGACGGGTACCAGCCGGCGGGCTTCTGGATAGGGGTCCCTGTCAGGGGCGGTACGCTGCAAAGTCTCTGGCAGGGGCGTAGGGCTGGTAAGGCTTTCGAGTGAGCCCAGGCCTCCGGGGAGTCAACTTTTTTTCCAGGTTAACTTTGTCATCTCCAATACTCCTCAAGCAGTACATCACTCCTCTTGACAAGATGGGCAACAGTGTTAAGGGAATTCACTTTTGTCACGATCTTGTTTTCTCTGTGTAACTTCCATAACTATGATAATTTGAGACACTTTTGCAAAAAAAACTTGATCCTCGGAGAGAAAGGAGGTGGATCAAAGGCATTCCTTTGGAC	632	643	257	268	11
2S43D:02066:10293	CCATTATTTAAAATTATTAACCACTCATTCATTGACCTACCTGCCCATCCAACATTCATCATGATGAACTTTGGGTCCCTTCTAGGAGTCTGCCTAATAGTCCAAATCATTACAGGTCTTTTCTTAGA	392	404	36	48	12
2G5Z3:04429:07864	TCTTGACAGTCGGAGGACACAAATACATGGATGATGATGGTTCACTTTCTCCTATTGAAGAGCCATTAACTGAAGATGAAGCAACAAATCCCTCAGGCTGAATGTGGATATCAAGTTGGTTGAGACAGTTGCTTCATAAATAGTTCAGAATTCTCAAGGAAGAGAAAGCTTGGAACAAGATGAAGATTAAGAAAGAATCTACATTTTCTAAAAAAAGCCAAAGAGTGCCACACCCTCCAGGATGTCTATAAAATTGGTAGGCATTGGCACTGTCCCTGTGGGCCGAAGTGGAGACTGGTTGGTTATTCAAGCCTAGGCTAATTGGTGGTTACCGATTCTTGCTTCTTAGACCCCTCTTGGTGCTTTTTGCTGTTTATTTCCATATTCGGGTTGGTATGAATGTGTTAAAGGGAAGGCCTCACTTTTCTATGTAGCCTTCTTTCTCTCCAGGTTTGCCTGTCTCCCTCTGCACAAGAGGGCAGAGGGCATGGCAGAGGGCTGCTGATTGAGCAGACCCCTCCTCCTCGCTTCTCTGGGGAAGATTGGTTTTGTACTGAGTCTGATGAATGGTTGGGGATGGTAACAGGCGGGGGTTTATGCCCACTGGGACTTGGTGAACTATGCCACTGGGATGGGAGATATTGTAAGA	13	23	172	182	10
2S43D:08886:13841	GGCCTGGGAAGTTCTGGTTCTTTTTTCCTCCCATGTTGCCAATTCATGTTGTAGTTTTGGAGGGGTGGTGGAGAGCGCATGTCAATTATTCTGTGGGTTGGCGTAATTGCCCCGGCCTGTGGGGCGGGGACGGGGGCCCTG	141	151	15	25	10
2S43D:07983:11792	CCCCCCCTTTTGCATTTTGTATTTTCTTTGATTGTTGTGCCGATGTTCTCTATGGAATCTTCTGCACCTGAGACTCTCTCTTTACATCTCTTGATTCCAGAACCTCCACTCTTTCGACCCCTTTGCTGATGCAAGTAAGGGTGATGACCTGCTTCCTGCTGGCACTGAGGATTATATCCATATAAGAATTCAACAGAGAAACGGCAGGAAGACCCTTACCACTGTCCAAGGGATCGCTGATGATTACGACA	355	365	124	134	10
2G5Z3:00943:09637	CTTGTCACAGGCAAACACCTACACCAGTGATGAACTGAGCACAACAGAGAATGCCCTCTTCTGCCTCAAGTGACCCTTACCTGCTCGCACCACTGAATCCACACCCCCAGCATCTCTGAAAGAGGAAATGCTCTCAGAGACCACATATCATCAGTGTGTTATCCACTCGCTGCTGCCTCCTTACAGGAGCCCCACACCAGGCCATCTGCTTGAATGCTTCGGACACACTCCTCTAGTTTTGTCATGTCCGTCTCATCATCCAAGGCTTCACGTCTAGTAGGATGGAGACTTCGCAACAACTGCAGGCTCTAAGGAAGATTAAGAAGTGCACAATCCATGGAGAAATTGAATCTCGGTGCTGACTCAGACAGCTCGTCCCAAAAGAGCCCACCCCGGCCGCTCGGGACGTCGGGGTCCCGGGACCATCACGATTCACACATTCGCACCGTCAGTCGATCCTCCAGGAATGAATACAGATGGCTGTCACCCA	79	89	38	48	10
2G5Z3:09746:04536	GGCTCTAAGGGCACAACATGGTGGATGACCTGATGGTCCCAGCCAACTGTGGTAAGAAGGGAGTGATTGAGTGGAGACCACGTAGCATCTCTCACAAAGTCTCTGTGGCTCGACTTCTAACACCTCAGAAAGGCTTGAATCCAGCACAGCAAGTGAACAGTCTTCACTGAGAGGCGTTTTTCTGGATATGGAGAAGAGGAATGTCTTAAATTTGGTCCACAATCTGCATCGTTAAGAAATTTATTTGTAAACCTT	77	87	8	18	10
2G5Z3:08541:01473	CTGCAGTAAAGAAGGCAGGAAGACACTGCTAATATGTGTTCATTGCCCAAAATCACATTAGACCTTTAGGATGTTCGTTGCCTCAAATCAGCATTTCCACAAACACCAGGGTGACCGTAATGTCCTCATCTTCCAGTGCCTCATCAACCCAGCAGGTTCTGTCCCTCAGCACCTCAGCTCCTGGCTCAGGCTCTACTACTAACCTCTCCTGTCACCACCACGGTT	309	319	204	214	10
2S43D:07535:08077	CCAGAGTGTAAGAAGCAAGAGAGCGCAAAGAAGCAAGAGAGAGAGAAAAACGAAAACCCCTTTCTATTTTAAAAGAGAAACCAACCATTTGCCTAGGGCGCATCACTCCCTTGATTGGACTTGCAGCCCATGGCCGAGCTGACGTTCACGGGAAAAACATTTAGTGAGGCCCTCGGATCGGCCCCGCCGGGGTCGGCCCACGGCCCTGGCGGAGCGCTGAGAAGACGGTCGAACTTGACTATCTAGAGGAAGTAAAAACTTCTCCCTGGTGGGCTTCACCCAGATGACTATCTGGGCCAAGGGCAAACACCGCAGCTACCTGAAGGAGTTCCGCGACTACCCGCCCCTGCGCATGCCCATTACTTCCCTTCCTGCTCTGAGCAGCTCCTCACGGCTCTGTCCAGTAATACTCTCACTGAGGGGGCCCGCGCCGAGGCCGCCCAGCCTCCCACCACCTCCACCAAGCCTTTAACGGCCAAGCCCACCTCCCTCGCCTGTGCTCTGGACTCTTCCAATGCCACTTTTCTGTTTATCCGAGATCATTCCACATTGTTCTTTCATCATTTCAGTTTCCTTGTAAAAGCTGTTCATGGCTTCCTGAGCTGAGAATTTTCTTCAAGGCATCTTTATTGCA	534	544	348	358	10
2S43D:08181:03004	CATGGGTGAGCCTGAGCTTGGATTTCACTGTGCCCAACCTGGGAGTGCTCCTGTGGCTGGCCCAGAAAATGCTAGATTTTCCTCCACTCGTCTGAACGGGGCTGGAGTCTAGGCTGAGGGTTTTCTCATTGACCCACCTGGAATCTGGTGAAGTATGA	210	220	52	62	10
2S43D:04429:13837	ACTGCTCCTCTCGTACACTTTAAGCAAGAAGACTTGACTCGTCAATGATCTTCTCCGGCCCTCATGGGGATGAAAGAA	36	46	50	60	10
2G5Z3:05984:08198	GGGAGAGCTGGAGAGGTTTGGTTCCCAGGACTCATGTGGCAGCTCACAAGCTGCCTTTAACTCCCCGTAGGTCCAGTTCCAGGTGATCAAGACACCTCTGCCTCCTCAGGCAACACACACGGGCACACACACGGGCACACACACGGGCACACACACACACACGGGACTCTCACCAACACCAGCAAATACAGAGTAACCACCATGGGCTTGGCGACATTGTTGATTAGCTCCATGATCAGTACTGTCTTTCCAACGCCAGCACCCACCAAAGATTCCGATTTCCCACCCTTGGCGGTATGGGGCCAGCAGATATCTCCATGCGGAGCAGTGCTGACTGGCTGCAGGAGGATAGCTTCAGCTCAGCACATTCTGCTTGCTGAGTTCTTTGAAGTTCATAACCTACAAAGGGATCGCCTCCCCTTACGGCCGCCAGCACCACCGCTGAATCCTTTAGCTTTCACGTGTGAGTTGTA	274	284	332	342	10
2S43D:05441:12894	CTCATCTTCTGGTTCGTTCTTCTTCTTTGAGCCTGTTGGCCTACCAGGACCCTTCTTTCCTGCTTCACTTTTGCCCTTGCACGGTATGCAGCAATATCCTTTTCATACTTCTCCTTTAGTTTAGCTGCTTTCTGCTCATATCGGTTTGTTTATCTTTGGCAGATTGCTCAGACCACATAGAGGAATCGTGCCCCAGACCCCATGAAGACCCCCGGAAGTAGCCTCAAGCCATTCAGGCCTACATCCATCGTTCCTAGGGACCCACCAGGCCAGCCAAGGACTCTGAGTGCAAAGCCAGTAAAACCCTGTCTCCAAATAATAATAATAATGATAAACTTGCTACAAATTATCAACTACGCAGATAATATTGCCACATCTAAAAGAACTCACAAAATATTGTTTGGTTTTTAACAAAAATGGCTTTTTAAAAAATAAAATTTTTGATTTAAAAAATGCATAAAGATAATGGGAAAGAAGTAGATAAAAAGCCACTTTCTTTGAAACCACTCATTCATTGACCTACCTGCCCATCCAACATTCATCATGATGAAACTTTGGGTCCCTTCTAGGAGTCTGCCTAATAGTCCAAATCATTACAGGTCTTTTCTTAGCCATACACTACACATCAGATACAGGACCAAGAAGCGAGTACTTACTCTTCGTAAGTCCTTGCTAGGTTCGAGACCAAACGGCGGGCCTGGAGAAGATTACCAGGAATTCATTACACCACCTCCAAATTTGGCCATTGGTCGCTTCCAGACCATGGAGGAGAAGAAAGCACTTT	392	404	519	531	12
2S43D:00273:09462	GCTCGGAAGTATTTTTCTTTGCAGGATTCTTCTGAGCTGTTCTATCCTATTCTAGCCTCGTACCAACACTATGATCCCGGGTTCCTGACCCCACCTCCCCCAGTTCGCCCTCAGTCGAAGCACTCGTGCCATGTCCTGCTGGGAATTTTCTGCCCATGGCAGGCAAGACCATCAGCACCGAGAACCCTGACAGACAACTACATACCAGCTAATCCTAACTCATGGCCATGCACTCAAGGCCGTCGCCCTGGTGCAGGGGTTCGCAGGGCTGCATCCGGGTTCTGGTCGTGGAAGTAGATGGGAGGCAGCCATGAGCAGGAAAGTGGTATTGGTCACATCCACACTCCTGCTCATCTCCCGATCCACTCCAGCACGATGCTGTCCCTCTGGTTCTCACTGGCAAGGTACTCAGCAAACATGCGCGACACCTGGATTCTGGGGCCGAGGAGGGTTGAGCTAGGCATACTTAAGTCTGTTCCTTAGGAAAATGATGAGAGGCAGGCATTCCCTCAGCTTGTGAGGACCAGTGGATGGACGAGGAGCAAACACGCCAGTCAACTTATCCAGCATCCAATGTTTTGGAGCAGCTACACGCTTCAGGTGTTTCTTGGGACCACGAGCCATGGCTGCGCAACAGCTTCCACATTCCTAAGAAAGGCCCAAGCCGCCAAGAAGCCAGGGAAGCACAGTACAAACCTCTGAAAGGCCAAGGGCAAGCAAGGCAAAGGCAGTACCGTCCGCCCCCGGATCTCTGCTGTTCTGGCATCAGCACCGCCGGCCCTGGGCAACGATGTACAGCGAGGACCTTAGCTCGGGCGAGGGAGGCCTCCCGGAAAGTGTTCTTTTTGGA	142	152	838	848	10
2G5Z3:09933:12740	GCCTTGACTGTGCCGTTGAATTTGCCGTGAGTGGAGTCATACTGGAACATGTAGACCATGTAGTTGAGGTCAATGAAGGGGTCGTTGATGGCAACAATCTCCACTTTGCCACTGCAAATGGCAGCCCTGGTGACCAGGCGCCCAATACGGAGGGACAGCGGGCCGGCCAGGAGCGGGTTTCGAACAATTCACGACAGCCTAACTAACAGGGGTGCCATGGGTATCATGCTGTCTACGACATTACCAATGAGAAGTCCTTTGACAACATCCGGATTGGATTCGGAGGCGGGCAAAGCCAGGTGCTCTGATGAGCTCGTACACTGAAGGCCCTGTCAGGACCTGTAGCCCTGGAACACCCAGGACCGCTATACTTCACATTGGTAGCCTCGATGGACATGTTCCACACACGCTTCAAGCAAGAGGGTGTGCTTAGCCCCAAGGTTGGCATGGACTACAGGACCAGGCATCCTGAGGCCAGGGGGCATCTCGAGGACGCCAGCCGCCATGCTGAAGCAGTC	97	107	300	310	10
2G5Z3:10219:11430	GGAGCCCAGGGATAAAGGTGACCTGGAAACAAGGGACCAGGAAACCGTTGGAGTATGTGGTGGACTGGGCTCAAGATGGTGACAGCCTGGACAAGCTCAACTGGACCCGTCTCCCCCCTGGAAACCTCAGCACTCCAGTACTTTCAAACAGGCCCTGGCCACCCTTTGCTCTGCCCGGGCATAGACTGCACTCCCAATGCACGAGGAGGCCAGGGCTGGGGCTGCATTGTCCTGATCGTGTACTGGGCAGGATCGCTGTGTCCCACTCCCTCTGCTCTTTGCCACAGAGACA	301	311	244	254	10
2S43D:08155:01482	CACCATCTCTGTGCCTGGTACCTGGGGCTCGATGTTCCGGACCCGGAAGGAGGATGGTGTGCTGATGGAAGCCACAGCTGGCACGTCTTCCAGGCTCCATTCTCCAGGCTTTTCCAAAGATTGTATATATTCTCAACAGCTACTCCGCTTTC	447	457	63	73	10
2G5Z3:04249:11791	GGCTCATCACAGTTTGGATGCGAGCACACACAGATGGGGCTTGGCGCTTGTCTAAGGCTTTGGCAGCTTCGCGTATGCCACGTGCTAGGCCATCGTGGATGAGGGCGGTCTTCAGCACCTCTTGTAGAGCAGTGTTGACCGTCCATTACATCCTCCAGCAGCTATGCCTCCTCGGCCATGGCGGTGAACTCACGGTGACGCCGAATCTTGAACGCACCCGAGCTTCCGCCTCCGCGCAGTCGGCAGCCCTGGAAGGCCAACACCAGGGATATGGACCAGCTTGAGTGACAGTGTTTTCTGCAGCAACATCGAAGAGGAACTGAAGCTGGAGGATGACGGGTGAGTCTGCAGGGGTGGGAGGGAAGGAGCCACAAAGCCTGTCTGGCCTGGGCCCCCATGGCCCCAGGTACAGTTCAAACACTCTGTTCAGCTGCTGCAGTGTGGCTGTCAGCAGGCTCAGTGAGGGGAACTCATAGACTTAATGCTAGTGTGAGTGATAGGGTAGGTGCAATAATAAATAAGGATATAGAGGTTGTTAAAGGGCGTATTGGTTCTTTATAAATAATTTTATGGCGTCTGCAAATGTTGTAAAATGCCGTATGGACCAACAATGTTAGGGCCTTTTCGTAGGTTGTATGGCTCTCTTCAGGCAAGTGGTGGTGCTGTCTCGTTAAACTCTTTGAACCTGACTTGGAAAGCAAATCAAAATGGGAATTATCCTTAGAAACTGTGCCTACAATGGATGGACTGGAGGGTATCATACTGAGTCGAAGTAACCAATACC	119	129	442	452	10
2G5Z3:02341:12115	GTCGGGAGAACTCTTCTGGTGGGTGAGGAAGGTGACAGGAGGGACGGACAGACGCACTCATTCTGTCCAATCCTTCTTAATGGCCAGGTTCCATTCCCAGGTGAGGTGGATCCTTCGGTTCCAAGCGGGGTAAAGTCCTGGGCACAAGCCAGTGTCACCCATGGAGCCCATGGAGATGGTGGAAGGGCATCAAACCTACTGTCGCGATTCTCTCGAGAGGAATTTCCGACCCTGCAGGCGGCTGGAGACCAGGACAAGGCTGCCAAGGAAAGGGAGTCTGCCGAACAGTCGTCTGGGCCCGGATGTCCAGACACCTCACCAGGCAGCTGCCAAGAGCCAGGCCTCTGTTTTAGCACACTCCTCAGGGAACCCCAGGAGGTACCTGCTGTTGGCTCCGGTTCTTAGGCAGCAAAGGCAGGGATCCACCCCTGCCCCGGGCTCTCCTTGGGACCCTACACAAGAGGCTAGGGACCCTTGCAATACCTCGAACACAGGCAGGCTGTGCCTTCTGCCGTGGCAAGCGCACCTACGGGCTGACTCCTCACTACATCTACCCACCCAGCTTGTGCCAGCCCAGCCCCTGGTACACGCACTGTCAGTCAATACTCCGGTGTGAACACAGGTTCCTCGAAGTAAATCACATTCTGATGAGGGATATGCAGACACGTCTGGCAGAGTGGGTATCTCACTTGGTAGGAACCTCGTACTTGAAGATGACAGGCAAGCCCGGCCGTCCTGGTGAGCGTGGACCTCCTGGCCACTGGCTGGTGGCTCTGCCGGA	75	85	137	147	10
2S43D:09871:09006	CCACCACATACTCCAACGGTTTCCTGGTCCCTTGTTTCCAGGTCACCTTTATCCCTGGGCTCCCATCAGCACTGCTCACTCCCACGTCACAGGGGGCAGATTCTGGAGCCAAGCACACACTGGGCCCAGTGGCCCCCTGCCCCCAGCCACTCCATGGCCCCTGTCATCTTTTGTCCCTTCTCAAAAAACTTACCAGGGCAACTTATGGACTTCCACCTGGGCTTCCTGCAGCTCCTGGGGACGTGTGCTCCGGGCTCGGAACACACATTTATTATTAAAAAATCCAAAAAAATCTAAAAAATCCATCCTCAGGTTCAAGCAAGTCAGCCCAGTGAGTGAATGTGTACTACCAGAACACCTACCGAGTACAATGGCCATTCGGTGCATCCTATGGGCATACCGTATAGTTACAA	312	322	159	169	10
2S43D:02502:03630	GGCAATAGGACTTAGGAATTGGCATTGGGGCCCTTCTTCTTCCCAAAGGTGGGCACAACATTGACAAAGCGCCGGTTGTACTGCATTCGCCTCTTGGCCCGGCCTGTCTTCTTCTTCTTCTTTTCCTGTTTGGCCACCTTGGGAGTCTGACA	76	87	49	60	11
2G5Z3:06933:01495	CCAAGTTCTGTCCAGAAGCAAAGAGGACCCCTTTCTCCCAGGCCTCGAGATCACCGCTTCCGTGGAGCTTCGCCGACACAGCCACCTCTTCTTCTGCTTCAGGTCATCGTACTCATAGAGACCAAGCACAGCTCCTCTGCAGCAGCTGGTACCCTACCCTCGCATCCACTTCCCTCTGGCCACTTATGCCCCTGTCATCTCTGCTGAGAAGCCTACCATGACGCAGCTTTCTGTAGCAGAGATCACCCTACACCAAAGAGTGAGCACAAAGCTGTTTTGAAAAGACTCAAGGAGGAACAGACTCGAAAGTTAGCCATCTTGGCTGAGCAGTATGATCATAGCATTAATGAAATGCTCGTCCACACAACGCTCTGCA	312	323	190	201	11
2S43D:01824:02348	GGTGGTGCGGAGCGTGTCGGCTTCGAGCTCCTCGCAAAAGTGTGGCGTCGCGCTACGGCTGGCGGCGGAGCCTACAGAGGAGAGCGTGGTGTTGGTGCATGTGTTTCGGACTCGGGCCTCATGCTTGCTGGCGTCATCCTCGGAGGGGCGTACCGTGTACAAGTATTTTGCCTCTTCAGCCAGATGATGTGTACGTACTGTGGACGGCAATCATGTCTCGAATTTTTCTGTAGGCATTCTGCCAGATTGCGGAACTGTATACCGGCTGCTCTCAGAGGTAAGTACCAGTCTCCTGCCTTGTTGATCTTTATTTTTATGCGTGATGGGCATCTTCTGGACGCACGGGCTCCTCAATCCAGTCTGCACTGGCCAAGTCGAAACCTTAAGTTATCTCCTCTGATGGTCAGTTTGCCCTCTCGGGCTCCTGGACGGA	93	103	262	272	10
2G5Z3:02507:01342	GCTGTGCTCGACGTTGTCACTGAAGCGGGAAGGGACTGGCTGCTATTGGGCGAAGTGCCGGGGCAGGATCTCCTGTCATCTCACCTTGCTCCTGCCGACTTTTGGCTGTCAGTTGTACATATCTAACAATTTCTAGTCTCTTTATTTAAGACCAATGTAGCTCTTCCTCCACTCATGCATCATTGTTTTGTTTTCAAGCAAG	241	339	0	98	98
2G5Z3:00054:06714	GTCAGGGCTGGAAGCGTGGCGAGCTGATGTGAGGCTGGTGGAAGGCATGGGCACTGTATACCACCTCGGGGGGCGAGGGGGTGCCACTGGCCAGCACGGAGCACAGGGGCTCGTGGCTGCTCAGCACTGATGTGAAGTACTTGAGCA	493	503	103	113	10
2S43D:06686:00522	CTCTACCCTGTGCTAAGGTGTATGAGTTTCGACCCCAGAGCTCTGTGTGCTTCCATGTTGTCTGCTCTCATACAATAAAGCCTAGAAAGCCAATAGACATTATTGCTCATACTATTCCTATATAGCCGAAAAGGTTCTTTTTTTTCCGGAGTAGTAAAGTAAACTACATGTGAAAATAATTCCAAATCCTGGGAGGATAAGAATATAAACTTCTGGGGTGCCCAAAGAATCAGAACAGATGTCTGGTAGAGAAATTGGGGTCCCCCTCCTCCAGCGAGTTGATAGATGGATAAATATTTACAATTTCCTGTAACAGTGCTGCAATAGTACCAAATGAATGCCATAGCATGGGTGCAAGGTCAGGGACAGACTCTCTCTTCTTGCTCAGCTACCAACAAAGTCATTTTCCCTTGTCTCAGGACTGGACAGTTTCATTATCCACTGATTAGATCTCTCTCTGCCACTTGGGCTAGCCGATGTCCACTTCAAGCCACTTCTTCATCACGTTGTACTTCTTGAAGAAGCAGGTCACAGTCTGCCCAGCCTGGTACTGCCTGATCTTCTA	141	151	132	142	10
2S43D:08076:07199	TTCCTGAAGGTGCAACCCAAGAGCCTACGCGGCTGGCCCAAAAGCAGTGGCTTCAGGCTGCTGGCTTTCAGTGGATGACAATGGTCCTCTGCATCTTCATCTTCGTCACGACACCAGACAGGATCCGACCTCGGATGGAGACGTTACCAA	443	453	129	139	10
2G5Z3:01493:09945	GAGCAGGCAGAGCAGGAAGTCCATGATTTGAAGGGACAGGAAGGGTATCAGGTACTTCTCCCGGTTCTTGACCACGCCGAACAGCAGGCTGATGCTGATGATGAAGAGCACGCCAATGAGCAGGAGCTGGAGAGCATGGCAGCCATCCTGAGGATACGGCATCTTGAAAGAACCTACAGGACACTTACCGCGGGACCACCTCCACCTACCATGAGCCACTAAGTAATGTCCCAAATTTTCCAGAAGAAAGACTACAAACAGTATCTTTGTGACCCTTTAAAATATAAAGTGGCATTGGACTGTCCAGCGAGAAAATGCAAATATTGTGGTCATTTCCTCCAGTGGCAA	138	148	59	69	10
2G5Z3:06364:07259	CTCCTATAAATAATCTAGCATCGACATTTGGGTATTTTCCAAGCAATTTCTTACATACATCAATGGCTGGATCATCATGATCTTGTACACAAAGGAGTACTTCATATTTGGACTTTGTAGACCAGGCCTGCCTCTGCCCTACCCAGTGCTAGGGATTAAAGGCGTGCGCCACCTACTGCAGTGCTGGAGATTCAGGGCAATGGCGAGTCCTCATATGTGCCACAGGAAGCCATCAGCAGTGCCATCCAGCTACTAGAAGACTCATTACAGAGGGAGTTTATTCAAAAGTGCCTGCAGTCTGAGCCTGCTCGGAGACCAACAGCCAGAGAACTTCGTCCACAATCGACTGTGGCCGGCTGGGTGTGGCGGACCGCTAATCAGGCACATAGCGTTGGCTACCCCGTGATATTGACTGAAAGAGGCTTGGCGGCGAATGGGCTGACCGCTTCCTCGTGCTTTACGGTATCGCCGCTCCCGATTCCGAGCAGCGCGAGCTGGCAGAAGTAATCATATGTGTTCTTGGGTTGTAATAAGGTGTTTGATAGAGTAGTAGGATCCATTGACGCAGATAATGTTGAAACCTCAATACCCCAGCCATGACGTGCCATTCAGGCGGTGCTGTCCTTGTATGCATCTGGCGCACCACTGGCATTGTCATGGACTCTGGTGACGGGGTCACACACACATGCCACTATGAGTACGTTCTGGTTACTTACATTCTGTTTCTTGCTTTAAAAGAAGGACAAGACTGTTGGACCAGTATTGCAATTCTGTAGAGTCTTTCTTATTAAAAACAATAATGTGATTACCAAAATTGGCATATTTAAGGCCTAATGCCATTCTAATAAAGACCTGAGACTGTCCAAGCACACGAGGGGATAAGGGGATGTTAAAAGGGACATAAGCTTGTTTTTCTTGATGAATGGCAGAGCTTGCCTCTGGACTTGCCGCCAAATCTGAGCTCAGGCTTGCCTTCAATGGTCTCATGTGGCTTTGGCTGGCCCTCAAAGTTGCTAAGGATAACCTTACATTTTTGATTCTCTGGCCTCTACCTTGTGAGTATCATGATGTATTGCAAGCATGAGTCACCAGACCTAGTTTTCATGATAATACGTTGCTTCCTCAGACACAGGTTTAGTGTCCATCCTTATTTCAGTTCTTCTGTGCACATACATGGCCAAAACAAAACAAAACAAAAACAAAAACAAAACAAAACAAAGACAAGACAAAAACAAACAAAACCTTTACCTTGTGTTTTCTTTAAAGAGAACACCCAATGCAAGGGATAGCGTGCCATGAAGTAACCTGAAGGAG	625	648	341	364	23
2G5Z3:08818:12305	TCTTGTTCCATCAATAGGCGAATCTCATAAGCATCACGGCTCAGATTCATGATGAGGGAAAACAGATAGTATCTGAATGAACGCTGTGCCCACTTTTCCA	175	185	72	82	10
2G5Z3:02215:03443	CCCGTCACCAAGCTGGGCCGTCTGGTTAAGGACATGAAGATCAAGTCCTGGAGGAGATCTACCTGTTCTCCCTGCCCATTAAGGAGTCTGAGATCATTGATTTCTTCCTGGGTGCGTCCCTAAAGGATGAGGTTCTGAAATCATGCCAGTGCAGAAGCAGACTCGGGCTGGCCGAGCCGGGACCAGGTTCAAGGCTT	395	405	70	80	10
2S43D:07386:09171	CTTGCCTTGTATCAAATCTTTATTATCTTCCGTCATATGAGGACAGAGACCAAAAATGCTATCCATTGGAAATAAATTTTCTTTGATTCTTTGTCCACTTGGTCATTTTTCTTTTTCAGTACTAATGCCACAGTTTTGTCTCAAATACGCCTGCAGAGTTAAGCATGCCAGTATGGCCGAGCCCAAGACCGTCTACTGGGATCGAGACATGTGATCAAGCATCATGATGCTCTGAAGATTCATTTGAACCTGCTTAATTACAAATCCAGTTTCTAATAATGCTATACAATTTATTGCACGCAGAAAGAAATAGCAATGTACATGGGAATCCTGAACTGCTCCTGGGAACCTTTGGGCGACCTGGAGACTCCACCTGTGCTGTATCACTAGAGTCAGAAATACCATCCAATAGAGTCGTGGGAGGTGAAGGTGCCTTCCAAACAGAGTTGGGTGACCATTCCCCGA	24	35	292	303	11
2G5Z3:05348:03089	GAGGATTTCTGAGTCTAGGCCAGCCTGGTCTGCAAACTGAGTTCCAGGACAGCCAGGGCTATACAGAGAAACCCTGTCTCAAAAACCAAAATAAAAATAAAATAAAAATAAAAATAAAAATAAAAATAAAATGTCCTTGTTTGATCTGTTGCTGATGATCAGAAACTTATGATATGGGACACCAGATCCAATACCACTTCTAAGCCGAGCCATTTGGTGGATGCATCAGGGGCTCGCGCCAGCCGAACTGTTCGCCAGGCTCAAGGCGCGCATGCCCGACGGCGATGATCTCGTCGTGACCCATGGCGATGTCTGCTTGCCGAATATCATGTGAGGGGGGGTGTGTGACATTAAAGGGAAGTCACTTCATCTAGATGGAGCCTAGCATGACAATCAAGGAAGACATTCTTTTTCCTCCTTTTAATTTTAAAAAATATCCTTTTACTCTCAAATTCTGGAACTTAAGCCAGGAAA	489	578	222	311	89
2S43D:06101:09620	CTTCACCAAAATCACTAACAACCATAAAAGTAAAAACCCCTTGAGAATTTAAAAATGAACGAAAAATCTATTTTGCCTCATTCATTACCCCAACAATAATAGGATTCCCAATCGTTGAGTCTCATGGGCTGAGGCCCTCAATCTCACAATCATGGCTGCCAAGCTGTAGCAAACACAATGCGGAATAGATGCACAAGAAGTTGAACCATTGAACTATTCTACAGTGTAATCCTTATCATAATTTGCTTCTCCCCCTCTCTAATCGCATCTCTACTGTGAGGCGGCTCCTCCATGCGTCCAAAGCTCATCTACATTTCTTTTCGCATACAGAACTCATCATTTCCTCCAAGGGCTAGCATTGAAGTCTTTTCGTAGGTCAAGGCTTTACGGGGTATCCAGCTGCAGGGAGGGGCTGTCCAGCAGGTACTTGTTGAGGAATACCATGGAAATGGAGGTGACCCAGTAGAGAGAGACCACCAGCGCGATCTGCAGAGCCCCGGAGCAGAAAATGGCTTGTTCCCGCTCTCTGACTCCTCGGAGACAGCAGAGACTCCAGTCAGCGCCATGCGCAGGATCCTGGCCGGCCTTCCAGTGCAAAATTTTTAAAAACTTTGGAAAGTTGTGGTTTTCCAGTTTGTGTACACTCACCCCCCAAATTGTAGTCTTTACAAGTCGTGTGCATTGCACCGTTGGATAAGCCTAGGGGAAAATTGTTGAAACAAATAACTGATGATTGTATGTATATATAAAGATGACCCCTCCCTTACTATTGCTGTTTCCCATCCCTCCACCGTCAACCA	349	359	148	158	10
2S43D:03927:00604	GCTTTCGTCGCTATTGGGGACTACAATGGTCACGTTGGTCTTGGTGTTAAGTGCTCCACACCCATTATTTAAAATTATTAACCACTCATTCATTGACCTACCTGCCCATCCAACATTCATCATGATGAAACTTTGGGTCCCTTCTAGGAGTCTGCCTAATAGTCCAAATCATTACAGGTCTTTTCTTAGCCATACACTACACATCAGATACAATA	392	404	97	109	12
2G5Z3:09499:07943	CCACTGTGGCTGGGGCCTGTGGCCGTGCTGTCTGGCTAGTGAAGCCACACTCGCCCAGAGTTTTGCCATCATCAAGGAGCTGGTCATCCTTGTAAAGCCGCTGCTCCTCTGGCGGCCGCTTGAGGATGCCTCGACGATGCGCTTCAGTTCGAACACGGTGCTCGACTCCTTGGCGTCCGTAAACGATA	41	51	112	122	10
2S43D:02378:12581	CTCTGAGGAGTTAATAAATGGCTGGGAATCCAGCTGTGGGCAGCTCAGGGGGGCTGCTCTGGGCGGTAGTTAGCATCTCTAACGAAGACCTGGGCATGTAGCATAGGGGTGTAGCATAGCTGGCTCCATGGCGGCGGCTCAGAAGTCTCCAAGCGCTAGACTCACTCTGGTCCACCATGGTGCCACCCGGTTCTGGTCAATCATGTTAAAGGCCTCTTTGAACTCCTGGACTGGGACTGGTCAACATGGCGAACAGATTGGAGGTTGCGCGCTGAGGGCGCTTCTTGGTGGTCTTGGTTCTCGTCTTTTTTGCTCGACATGGTCGGCGGTTTAAATCTGACCTGATGCTGCACACCGAGAGGATCCGAC	94	104	51	61	10
2S43D:06390:09470	ATCGCAACTCCAATGTCTGCAGCCTTGAGAGCAACTGCATCATTTACCCCATCTCCTGTCATGGCTACAACTGCCCCGTTCTTCTGTAGAGACTTAATAA	308	320	50	62	12
2G5Z3:03110:02121	GTAACAGTGAGCCAGTTGTCCAAGACTTGGCTCAGCTTGTTGAAGAGGCCACAGGAGTTCCACTACCTTTCAGAAGCTCATATTAAGGGAAAATCTCTGAAAGAAATGGAAACACCGTTGTCGAGCACTTGGAATGCAAAATGGTTGCCGAGTCTGATTAATTGGTGAAAAGAGCAATGCCAGAAAGAAAGGTGGACTCATCTTGGCCATTAGGAAAAAGGACGAGCCCATTGACCTCTTCATGGTTGAGATCATGGAGATGAAGCATAAATCTGAGACAGATACAAGCTTAATCAGAGGCTTGTTTTGGATCATGGAGCTCGGCATCCTGATATGAAGAAGAGAGTGGAAAATGCCTACATCCTCACTTGCAACGTGTCCTTAGA	598	608	345	355	10
2S43D:02561:00477	AAAGAATCAGGAACAGATGCTGGGGTAGAGAATTGGGTCCCTGTCATCTCACCTTGCTCCTGCCGAGAAAGTATACCAGTCATGGCTGATGCAATGGCGGCGGCTGCATACGCTTGATCCCGGGCTACCTGCGTGGGAAAAAAATTGAAATCCTGACATTTCTAAGTAATTTAGAATATTTACAGCCATGCCATTCCACTCCAGGAATTCATCTGTTAGATTCTTGGCTCAAGCTGTTACACATGTGTTATAAAA	312	347	39	74	35
2S43D:00710:12359	GAACAAGATGGATTGCACGCAGGTTCTCCGGCCGCTTGGGTGGAGAGGCTATTCGGCTATGACTGGGCAACACTTAGGTGGCACCAACCTTGACTTTCAGATGGAGCAGTACATCTACAAAAGGAAAAGTGACGGTATCTACATCATAAACCTGAAGAGGACCTGGGAGAAGCTGTTGCTCGCAGCTCGAGCTATTGTTGCCATCGAGAATCCTGCTGACGTCAGCGTTCATCTCCTCCAGGCAACACTGGCCCAGCGGACGCTGTGCTGAAGTTTGCTGCTGCCACAGGAGACAGTTCGTCCCACCACGGGATGGCTTCTCTGGCCCTGCACCACGCAAGTCTAAACTCATCTGCGAGGCCACGAACTCACTCCAAAACCGATCACAGTATCCTGGCTAAAGGATGGGAAGCTCGTGGAATCTGGCTTCACCACAGATCCGGTGACCATCGAGAACAAAGGATCCACACCCCAAACA	13	82	0	69	69
2S43D:02674:07362	GCTTCCATCGTCCCTGTGCGGAGAGGCTACTGGGGGAACAAGATTGGCAAGCCCCACACTGTTCCATGCAAGGTGACAGGCCGCTGTGGCTCTGTGCTGGTGCGTCTCATCCCTGCCCCAGCGGCACTGGCATTGTCTCCTGCTCCTGCGGCACATCAAGCTGCACTCGGGTGAGAAGCCCTTCAAATCGAGGCCATCTTTCGCAACTTATGCCTGCCGCCGGAGGGACGCCCTCACCGGCCACCTGAGGACGCACTCCGTTGTGAAGACCCAGGGAAGCTCCATGTCGGGTATGTACTTAGGTAGAGTTAGCAGGCGCGTGGGAGACGCTCAGTCAGTCCAGCCCACAGCACCCGCCGCAGAGACCCATAGACTTTAGCACTCAGGA	54	64	19	29	10
2S43D:03561:09822	CAAGATAGCCGGCTATGTCACGCATCTGATGAAGCGGATTCAGAGAGGGCCTGTGAGAGGCATCTCTATCAAGTTGCAGGAAGAAGAGAGAATTCGAGCAGAATTAGGTCAACCAGGTGCACTTTTAGGAGATGACCAAATTTACAATGTTATCGTAACTGCCCATGCTTTTGTTATAATTTTCTTCATAGTAATTACCAATAATAATTGGAGGCTTTGGAAACTGACTTGTCCCACTAATAATCGGACCCCAGATATAGCATTCCCACGAATAAATAATATAAGTTTTTGACTCCTACACTTGAATCTCTCGTGTCTATTCCAAGAAAATGTGTCCGCTCGTGTTTCTCAGATTTCTGATATGATATTCGGAATGAGCATCGTTAGCAGCACAAGCTAAAGTGTTCGCAATGATGTCTGGGAGCCATGGCGTCGTAGTCCCGTGCACGTGTGAAAGAGCGGCCCAGCTTGGAGATCTTGCCGGTGCTTGTCATGTCAGTCAGAGTTTCTGGAGCATTCTTTTTCACCCTCGCCCTGCCAACCCTTGATCCATTTTGACATTTGTTGTGCACTATTTTTATATCTCTGTGAGCGATTTTTCCAGCAGTCAGCTATTTTATGGAGCCCATTGGTGTATGTTACTGGGTCCTACAAGGATGACTGAGTAAGGATGCTTTGCCATTATAGAGCTAGATTCTCACTGCTCTAGAGAACTCAGGAGGGAGAAAGGGTAACACTGTGTGAAGGAGTGTCTCTGCAGTGTCAATTGTTTAATTCTGTAGGGGCAGAGAGCTAAAGCCTGGCAGGATCTTAGCATTGTTAT	302	312	801	811	10
2G5Z3:06594:14254	GGACTGCAGGGCAGCAGCACTGGGGGCACGTCCTGCTTGGGGGATGGGCAGGGGGGATCAGGTCTTTCTAAGGGTTCCAAGATGCAGCTGTGCGAAGCAAAGCTGCAGGCTTGCTCAGGGTCACATTCCTTCTTGATGTGGCTGAACTTGTTCGCAGCTGGAGAAGCGAGGGATCCCGTAGTGGGTCGTTCCAAGGA	238	248	83	93	10
2S43D:01882:10062	CCGATCAGTAGATCCTTCCACTGGGTTTGCAATTTTGATCTGCGCCCCAGACATCTGACGGATCTTCATTGATTTTGGCGCCGTGACGCCCGATTATGCAGACCAATTGCAAATCCTGCGTATTGGATTCTTTAAAAAATAAAAGGAAAGACACTTTAACGCTGTGTGTTCCCCGTGACGGGTGGGCCTGAGAGGCCAGTGTGACCCATGGCAGGCATGTATTTCTGTACAAACA	562	574	200	212	12
2S43D:04798:03821	CCGCCACCAAATGCTAATGAATCCATGTCTCCTTTGATAAAAACATATTATCTCCTGTCCACTTAAAGACCTCAAATTCTGGGCAGAATGTGAAAACAAATGTTTCTCCAGTACCGTAAAAAAGCCATCACTTACTTTAAATGGCTCTGATGCTAATGCACCAAAACCTGTCCATCACTGTCTTTAATCACTA	98	108	143	153	10
2S43D:00204:09985	TGCAGCAGCCCACCAGCCTCACATCGCAGGTTTAGCTCCCGCTGCGTTTGTCCCAACCCATACATCATCAGCGCTGCTCCCCCAGGGACGGACCCTCACAGCTGACTGGCTGCACAGCGACACTCGGCCCAGCTGTGGTCCCTCTGAAGTTCTCAAGTTCACCCGTTAGGGAAAAGTTATTTTGTTTACATTATTATAAGGGATTTGTTATGTCTGTAAAGTGTAACCTAGACGCATCACTCCCAGCTGCGCAAAGCGTGCGAGGTGGCCCTAGAGGAAATAAAAGTGAATAGAGAAACAAAGCCCTCCTCATGGAGAAGCAAAAGCTGGATCAGGCCACCCTTCCACCCAGTGAAATTCAAAGACAAATTTTATTGAAGCAGAACAAGTGCTTCAGTTGAGGAAATGCCTCCATGAGATCAAACTGTAAGGCATTTTCTCAATTAGTGATCAAGGGGGAAAGGCCCCTTGTGGGTGGGACAATCTCTGGGCTGGTAGTCTTGGGTTTTATAAGAGAGCAGGCTGAGCAAGCCAGGGGAGGCAAGCCAGGAAGCTTTTGCCTGAGTACAAGGAGAAGGAGGTGGTGAATAAGGATGTCTTAGATGTTTACATTGAACACCGGCTGATGATGGAGCAGCGAAGCAGAGACCCCGGGACTTTAGTTGGAAGCATGGGATTTTCCTACAGTTGGT	274	284	103	113	10
2G5Z3:06572:13842	CCAGAATCAGGGAGGAGTACACCTGACACACAGGTTGCTCAGTTATCTTTACCAACTGCTTCCCGAAGGAACCAAGCCATTCAAATTTCTCAGAAAGAGCATCACCACGGTGTTCAACCTTGCTCCTTACTTTATGGGAAAAGTGACACATGGGCTTCCGGGAAACAAAACATCAATATTGCACTTCCCCGGCGCGGCGGGCGAGACGGGCCGGGTGGTGCGCCTCGGCGGACGTGCCCTGAGCAATAAGGAGTCCCACGTGCCTTACCGAAACAGCAAGCTCACCTACTTGCTGCAGAACTCTCTGGGTGGCAGTGCCAAGATGCTTATGTTTGTGAATTATTTCTCTCTCTGTCTGTATCTCTCTGTCTGTGTCTGTCTCGCTGTCTCTGTTTCTATCTGTCTCCCTTTCTCTCTGTTGGTCTCTCTCTAACTCTGTCTCACTGTCTCTGTCTCTGTGTCTCTGTTTCTGTCTGTCTTTCTGTCTGA	323	334	116	127	11
2G5Z3:00023:10103	CTAGAAGTGTGATCGCTTCCCCTGCTGAAATGCAATGCAAACTCTAGGGGCTGCTGACCTTGGGTCTCATCTCCTTGATTTTCTTTGTCCTCTTCATTGCCATCCTCTCTAGGCTGTCTTTGGCGAGGAGGGCCCCTTCGGAATCGTGGTCTGTAACCCCGATACATATTCTGTCTCACTGGTCTACCTTGCTCTCCTGCACCCTGGTTGATGCTGGAGATGTGCTCACTCTGCGGTGTCTGGTAGAACATGGAGGGCTGTGGCTCTAGTAGTCCTCCAGCAGTTGCACTGTAGGCCAGCTGTGCTTGTTCTTCTTCTCTGGTAGAGGAGGTGGCTTCTCTGTGTCACCCGTCCAACTCAGAACACTGAAATCACCCACAAACTCACACCAGAATCTGCCCCCTGTGACGTGGGAGTGAGCAGTGCTGATGGGAGCCCAGGGATAAAGGTGACCTGGAAACAAGGGACCAGGAAACCGTTGGAGATGTGGTGGACTGGGCTCAAGATGGTGAAACCAGATCTCATTACGGGTGGTTGTGAGCCACCATGTGGTTGCTGGGATTTGAACTTCAGACCTCGGAAGAGCAGTCGGGTGCCTTACCCACTGAGCCCATAACCGCATCGGAGACATCGGATTCATTTTAGCTATAGTTTGATTTTCCCTAAACATAAACTCATGAGAACTTCAACAGATTATATTCTCACGCCTCTTTGTGCTTGGAGTTCAGTAAGGCTTCCCACAGGGCCTTGGCTGAGGCCTCATTGGATGGGGCAAGGCAGCCTGGTGCAATCACGTTCTGGTTTTCCTCCACAGCCTGGACAGCAGTGAGCTCGGCCATGTTGACCATCACGTCGTGGGTGTGGCCTGGAAGCTGTGGAAGCACTGACATGCTGGAAGACAAGAAACGAGCTACAGACTGGGAGCCACAAATGAGGCCATAGAGGAGCAGGTGGCTCGAGAATCTTACCTTCAGTGGCTTGAGGGATCAAGAGAAACAGGCCCGCCAGGTCCGGGACCAGCCACCCCGGAAGACAGTGCCACATGCCAGTTCAGCCACAGCCAGCCAGCCTCCCAGTGCCTGG	239	249	296	306	10
2G5Z3:08447:07168	AAGATAAGAAAACAATTTATTATAGAGAGAAGAAAAAATTTTCTCATCCAAAAATATAGAAATCTGTACAACTTTGCCACAATCAATATACATGAACTGTACAAATTTACACCAGTTCATAATTTACCAAATAAAAAGATGACTAACAAAAGTTCACAAAATAGATGGTGGTTTGTGGGAAAAGACTCTTACAGTAGCTACACGATGCATTGCGTCTATCATGTTAAACGTGCATTAGACACAAATACAAACCCATGAAACAAGCCACCATCTTTAACAGTTGAGCAAAGATAAGATGCCTAAGGAATACAGGTTCAGATCTTCCGCTGAAGTAAAGTGTCCGGTCACACAGCCGTTCACTGCAGTAGCTCTGCGCCGTACGACGTAGTTGTATCGACATATTGAGCGCCCAACCTACACCAACCTTAACCGCCTTATTAGCCAGATTGTGTCTTCCATCACTGCTTCCCTCAGATTTGATGGGCCCTGAATGTTGATCTGACAGAATTCCAGACCAACCTGGTACCCCACTACCTC	172	182	483	493	10
2S43D:06850:06043	ACAGTTATCCATGATAAAAACTCTGCGAACATACAACTTGATGTTGTTCTTTTTCTTTCTGTTTTCAAACAGATCAAAAGGAGCGCGTCTTGGGACAAAAAGAAGGGCCCGGAATTCTAATTGTCCTTCAACAGAAAAATGCTTTACTGCCAAGTGTTCTTCAGGCCGTGCATGGAGAAGGTGCCTGGGCCACTTTGGAAGTACTCTTGAAGTGTTCACTGAGAGTACGAGAATACTTCATCACTGTGTCTTTCTTACATCGAAACATCGCCATGTTCAAAAGGGACTGGCAACGCAAGCATAAAACAGCA	270	281	280	291	11
2S43D:02759:04350	CCTTCCTCAACTCTTTCAGCTCCTCTCCACTCCTAGGTGGGCCCCTCCTTGTAGCCGACTCTCTCTTTGAAGCGGGACAGGAAGGCGGGCTCTGCGGGCCGCACATAGGACACTTGGTTCCGCTTGCTCATGGTAGTTCTGGTTCTGACCAACAATAAATAGCACTCGGCAGACTTGGCAGGGTACAAAGTGTCTGTCGCCCGCGCTA	261	271	67	77	10
2G5Z3:03875:05197	CTTGGCGTGGTGCGGTTACCCTGGTCATTGGCAATAATTTCCACCTTCCATGCTGGAAGACACCCACACAGGAGTAGGTGGTGCCGAGATCAATGCCAACTGCAGGTCCCTTAGACATGGTTGCTTGTGTGTAGGCCCAGCTGCGCTGACGACGAGACCACACAAATCCAGGCAGCTGCCTCCGACAGCAGAGCCCAGCTCCAGCCTCACTTCCAGTATCCCTGCCACTCCTGTCACCAAACGCCTCCAAGTCGTGACCCCTCACAACTCATCCAAAGTCTCACTCCACA	559	569	250	260	10
2G5Z3:00093:07578	CCGGGTTACAGCTCCTATTATACATAGTACCTTGGCTTTTTGATATGCCGGGGTTACAGTTCCTAATATACATAGTACCTGGCTTTTTATTGAATGCCAGGATAAAAGAGGAGTCTTTGGACGAGGGTGTAACAGTGATTTTCTCTCCAGACCGGGCCCAGTACGGAGAAGCGTAGGAGAAGGGGCCTGGTAACGTCATCCAACCATCCTCCTCGCCAGAGCTGGGTATGTTTTTGTTATGGCATCTGTAGCTGACATGTTCAATTCACTTTGAGCTCTTCACAGAGCCAAGTGTGAAGAAAAACGTTCTGACTGTCATGAAATTTGAACACTCCACTCTGGCACGGTGCTCCCATTTTACCGCCAGGCTCGATTGAGGAGTTTCACCTGTGCCAGCCTCTTTGTGATCATGGTGGCAAAAACCAGGCCAAAAAGGACACTGCTGATGAGCACATAGTCGTAGTCATCTTTCAGGACATCAAACTGCTA	519	529	361	371	10
2G5Z3:09579:11463	CCAACGCCGTTAGGATAGAGCAGGAGTTCCTCACGGAGGCCTTGCCCGTGAAGCTCATCGGGATGAACTGCACTTTGATGAAGCAGTACATTGAGTTTGTGGCCGACAGGCTTATGCTGGAGCTGGGTTTTAACAAGATTTTCAGAGTAGAAAATCCGTTTGACTAGGCAGCATATTCAAAAAGGTATCTGGAGGAGCAGAAGACTGAGAATGGGAAGGATGAAGGAGCAAGAAACAAACAAATGACCGAATA	179	189	62	72	10
2S43D:09637:04699	GGAGACAGCTAAGCAGGCTGATTGATTCCTTTGGAAAAGCCTTGGTGGAAATTCTTGAGGAAAGTGGTTTTTGGTTGAAGAAATAAGTTGTTTCAGGAAAATTATTGGTTGTTTGAAAACTTTTGAAGCCGGGCGTGTTGGGTGCACGCCTGGCTCATACAATAAAGCCTAGAAAGCCAATAGACATTATTGCTACATACTATTCCTATATAGCCGAAAGGTTCTTTTTTTCCGGAGTAGTAAGTAAACTACATGTGAAATAATTCCAAAGTCCTGGGAGGATAAGAATATAAACTTCGTGGGTGACCCAAAGAATCAGAACAGATGCTGGTAGA	141	151	219	229	10
2G5Z3:08237:03909	TAGCTGCCAATGACCTGGCTTGACTGCAGCAGCCAACCTTTCACCCGTCTGTCCACGCCATGTCGGCTGCTCCTCAGGGAGCAGGAGCCATTTGGTCCCCACGTAAGTTCCAGTCTGTGCAGTCTCCTGAGGCACTGCTGTGTGGTCCTTAGGGCTCTTTTGGGTGGCCTGGCACCAACACAATTCCCAATTGTTGCTCTGGAGCATGGCA	92	102	62	72	10
2G5Z3:06453:12256	CCTGCTTGCCAATCGCACAGCCCCAGTAACCATATGAAACACCTGATGGGTCGATCATATAGAGCTGTGCACCATCATTCGCCACTGTAAGACCCCAACATGAAAACTGCAGCCAAAAGGTCTAACCAAGGCGCTGTAGAGTGTATAGGCGTGTACATACA	578	588	0	10	10
2S43D:07726:11043	GGCCGGGCCGGAGGGGGATGGCTACACCACCGGACGGACAGACAGACGCTGACGGACAGGCAGGCCGGAAGCTGTGAAAATCCACTTCCCCACGGGCTCCCAGCACAAGTACGCTGTTCTGGTTCTTTTTTCTTCCTTTTTTTCCCTTTTGCA	141	151	120	130	10
2S43D:09773:11476	ACAACTTCAAGATTCTCAGCAGCCCAAACCCAAGTTCAAAGCCCCAAAATTGTGCAAGGTATTACACCACAGACAATCCCATGGCGTGCAAGCCAGTGGTCAAAAATATATCACAAACAGGCTTTTGCAAAAACCTTCAGTTTCGCAGCTGAATCCTGGAAGCCTTTTTTAATTCAAGGACAGATGTTTGGAAAGTTTATGGCAGTTTTTGAAGGCTGAGCAAGTAGGACATTCGCTGAGGGCGGAGGGTTGGAGACATCTGGTCAACATAGCAAGATGCTGTCTCAAAAATGT	84	94	68	78	10
2G5Z3:02512:07401	CAATCTGTCAGCGCCCATCATGTCCCGCTTTGATCTCTTCTTCATTCTGGTGGATGAATGCAATGAGGTGACAGATTATGCTATTGCCAGGCGCATAGTAGACTTGCATTCAAGAATTGAGCAGATCAGACTCTCCTCGTTCGCGCAGCTCGCTCGGCTCCTTCCAGCAACCATGTCTGACAAACCCGATATGGCTGAGATCGAGAAATTCGATAAGTCGAAGTTGAAGAAAACAGAAAACGCAAGAGAAAAAATCCTCTGCCTTCAAAAAGAAAACAATTGAACAAGAGAAGCAAGCTGGCGAATCGTAATGAGCGAGCGCCGCCAAATATGCACA	10	21	278	289	11
2S43D:02516:04823	ATGAAATGGCCTCTCACCTGCGGCGTTCCCAGTACTGACCTCATCTGTCCCTTCCCCACCGTTCCTTGCTTTGCACCCCTTCTTCACTACACAA	228	238	59	69	10
2S43D:05092:13062	GTTGAAGTCGCAGGAGACAACCCTGGTCCTCAGTGTAGCCCAAGATGCCCTCAGTGGGCCCCTCAGATGCCTGCTTCACCACCTCTTGATGTCTCATACTTGGCAGGTTTCTCCAGGCGCACG	574	585	65	76	11
2G5Z3:02346:06950	CCTTGATATACTGAATACAGTCCCGACCTGTCTTCTCTGAGTCTACAATAATAGCATCCATGTTCTTCCCTAAAACCTTGGTCACAGCAATCTGATACTTCTTTTGTGTAGGCTGGCAGAGGTCAATGAGGCGGCCATACACAGAGCCAGGGTAGAGACGCTTGATGCTTTCCATTATTTCTGCCTTTCGCTGCTGGCGGCA	158	168	22	32	10
2G5Z3:10184:04549	CAGTAACCTGGGCCACGTACTCCTGGGCTTCCTCTTCCTGCTGATAGTTCTGCGCAGAGACCCTTCTCCACCTCCCGGATCAGCTCGACACACCAAATGGAGCAACCTTCTAATTTCCACTTCCTGTTTATCTCCATTCAAGAGCATCTTCTCCTTTGAGGAGCTTCTTTAGTAGCTCATCTCACCAAACCAGTCCACAAACACAGAGAAAATAGCGTGGGGTATGAGCAATAATGTCTATTGGCTTTCTAGGCTTTATTGTATGAGCCCACCACATATTCACAGTAGGATTAGATGTAGACACACGAGCTTACTTTACATCAGCCAGACTTCAAATGGTCTTCCCACTTATAGCCACATTGATGACTGATAGCAAGATCATACGCTAATCTAAGCTCATGACCCCCGTTCAATCAATTCTAATAGGAGAATTATTCATTACCATATCATTATTTTCTTGACTCAAACTTTACCATTATTCTTATAGGAACTTAACATTATTATTACAGGTATATACTCAATCATACATAATTAGTTAACCCTCCCCCTTTTTCCTTTTCCTTTTCTTGTGGTTTCCGAGACAGGGTTCTCCGTATAACCTGACTGTCCTGGAACTCTCTGCCTCCCGAGTGCTGGGATTAAAGGCGTGCACCACCACCGCCGGGTGTCTCCTTTCTTA	316	326	176	186	10
2G5Z3:03565:09029	TGTAAATCTCACAGGCACACACATCCATATTGCTTAGGAGGAAGAGTGGATGAGAGGAAATTTTCCTTTCACTGCTCACCATGTTGTGGCTAGTTTGTATTATCATCTTTAGCTTAAAATATAAACAAAGACTTACACATCAACATTTTCAAGGTGTTAGGCTCTCTGAAGCTGGCTCCACCAGGCTTCACGGCTGCTCTCCTTCTGTATCTCTCCATTGCTGAAGGGCTCAGGCAAGGGGCCATCCAGGTGCTCCTGGGATGGGATCACTTTGCACTTCTTGAAGAACTCATCTGTTTCCTTGTCTACCACCAGCAGCT	93	103	190	200	10
2G5Z3:01018:01555	CTCAACACTCTGAGCAGAGTAATGGATATTTATTGGAAGCTTTGTGAGCTAGCCTGATGACGGCCCCTTCTCCCGGCTACCTGCCCATTCGACCACCAAGCGAAACATCGCATCGAGCGAGCACGTACTCGGATGGAGCCGGTCTTGTCGATCAGGATGATCTGGACGAAGAGCATCAGGGCTCGAGCA	388	453	72	137	65
2G5Z3:00519:05406	TTTATTTTCAAAATCTAATATTTTAATGTCAAAGAGTTTAATAAATGCTTTATAGTATCTTAAAGGGATCTACTTATTGGCTTATAGATTAATCCTAAAACAGCTACCTTATTAGAAAAGGGAAAAACAGGTTTTCTCCACAGAAGACAATCGGCTGCTCTGATGCCGCCGTGTTCCGGCTGTCAGCGCAGGGGCGCCCGGTTCTTTTTTGTCAAGACCGACCTGTCCGGTGCCCTGAACTGAACTGCAGGACGAGGCAGCGCGGCTATCGTGGCTGGCCACGACGGGCGTTCCTTGCGCAGCTGTGCTCGACGTTGTCACTGAAGCGGGA	180	271	240	331	91
2G5Z3:02303:14481	GAACCAGTGAAAGCCAGTGAAGCAGCTGTGAAAAAAGACCCAGCCAAAAGGCCAGACTGACCGATCCCATTCCCACCACAGAGACTTCAATCGCACCCCGCCAGAGGCCTAAACGCTGGGCAGACGTCACCAAACCCGGGAGACCGAGGAGCTGCATCACGACAGGGTGACCCTGGAGGTGGGCAAAGTGATCCAGCGGGGCCGGCAGAGCAAAGGCCTGACCCAGAAGGACCTGGCCACGAAAATCAATGAGAAGCCGA	214	224	232	242	10
2S43D:03966:13371	CACCTAGCACGATGAAGATTAAGATCATTGCTCCCCCTGAGCGCAAGTACTCAGTCTGGATCGGTGGCTCCATTCTGGCCTCACTGTCCACCTTCCAGCAGATGTGGATCAGCAAGCAGGAGTATGATGAGTCAGGCAGCTTCGTGCTTCACAGGACTGAATCCTCGGTAGTGGTTGAGGAGTCACTCAAAAAGAGAAGTAGAAATACACAGTGACCGAAGAACTGCAGGGGAAGAAAGTTGAAGCTAGATAGTTGGCAGTTAGGAGGCGAAAAGCTGCCTCGCTGGTATACAGAGCGCGCCTTGGGCACGGCAGGGAGAACATGCCTTTCTAAAGCAGAAAGTCTTTTCGGTTAGTGGGGTAAGGAAAGGAGGATAACACGAGAAAAGCCAAACCTAAAGCCCAAGCACCGGGCTCGGTTAGTGCCCACCGACGTCATCATTTACAGTATATACAAATAACAGTATTACAAGGAAGAAATACTCAGTCTCCA	181	191	220	230	10
2G5Z3:07976:06710	GGCTGGGTGAGCTCAGGAACTGTCAGGGCACGGTACTCCTGGCTGCCCGCCTGGTCAAGGGGCAAAGCCAGGGCATGAAGAAGTGCAGGACGAAGGGAAGGGCACCATAGTTTACAGCGTCCCCCACCTGCAGCAGCACGTCCTCGCAGCTTCTTCTCCCGTCCGGCGACCTGCTTGGAGGCTGGCCTGGCGCCTCCCTGGGTAGGAGAGAAAGCTGACTGAAAGGGGGCACCCTCCACAGATAGCTCAGCCAGCAGATGGGCTTACGAGCTGCTACGAGGATGGAGACCCTACGATATCCACTCGAGCAATGCTGTGGAGTCGCTGGTTCAGCTGTTCAGCACTGTGAGTGTCCAGTACGTGCCCACCTGGTCCAAGGAGATGGTAGCCCTGCTGCGAAGCTCCTCACCGTGAACCCTGAGCACCGGTTCTCCAGTCTCCAAGACATGCCAGACACGCCCCA	185	195	83	93	10
2G5Z3:08679:04516	GCATTTGTGCCTAAGCCTGGCTCCCTGAAGAGAAGTCTGGCTTCCCAGAGCTCAGATGACCACTTGAACAAACGGTCTCGCACCTCCTCTGTGACGCTCCCTGGCTAGTCGCGTGCACAGGAGGCATCCCCGACTCCAGAGACGACTTCACAGAGGAACGCCTGGCCAAGCTGCAGGACCCCTTCTCTGTCTACCGCTGCCACACCATCATGAACTGCACACAGACCTGCCCCAAGGGTCTGAATCCGGGGAAAGCGATTGACGGAAATCAAGAAGATGATGGCGACCTACAAGGAGAAGCGAGCA	179	189	209	219	10
2S43D:09714:10602	CCGCGCACTGCGCCCCAGCACTAGCCGCAGCCTCTATTCCTCCATCCCCCGGTGGCCGCTATGTGACCCGGTCCTCCGGCAGTGCGCCTGCGGAGCAGCGTGCCGGGCGTGCGGCTGCTTCAAGACTCGGTGGACTTCTCGCTGGCACTCCGGAACAAACGTGAGGTTTGGAGGGTCAAGTTTACCCTGGCCAAGATCCGTAAGGCGGCCCGGGAGCTGTTGACGCTAGACGAGAAGGATCCCCGGCGTCTGTTTGAAGGCAATGCTCTCCTGCGGCGGCTTGTTCGCATTTGGGACACTGTTCCATGCAAGGTGACAGGCCGCTGTGGCTCTGTGCTGGTGCGTCTCACTCCCTGCCCCCAGAGGCACTGGCTTCTCTGCTTCCTTGTGCCCAAGAACGCTCCTGATGATGGCCGGTATAGATGACTGCTACACTTCAGCCAGAGGCTGCACTGCCACCCTGGGCAACTTTGCTAGGCCACCTTGATGCCATCGTCCAACGGGAGAAACTGGGCCTGACCCGGATTCGGGACAAGGAACTGGTATGTGCAGCCCTCCTGTGCCACCTCCGGGGACGGACTTCTATGAGGGCTCACATGGTTAACCTCTAACTACAAATCCTAATGAGCGTCCTCCACCCAGCCCCG	365	375	271	281	10
2S43D:03895:10153	GTCCTGCTTGCTGAGTTTTCTGACTGCACCAGCTGATACAGTAAGTGGCCCATGTGGTCCCTGGTGATCTGGCTCCGATTCCACCCAAAGTAACAGAGAGAAGATGACGCAGATAATGTTAAACCTACAATTAACCCCAGACCATGTACCGTGCCACTTCAGGCGGTGCTGTCCTTGTATGCATCTGGGCGCACCACCTGGCATTGTCATGGACTCTGGTGACGGGGTCACACACACAGTGCCCATCTATGATGTAATTGCTGAACTTAAGAAACAGTCTAAACCTGTGACAACCCCTGAAGAAATTGCTCAGGTTGCTACAATTTCTGCAAATGGAGACAAAGACATTGGGAACATCATTCTGATGCAATGAAAAAGGTTGGAAGAAAGGGTGTCATCACAGTGAAGGATGGAAAACCCTGAATGATGAGCTCGGCCCGCTCCCATTCCGGCCTTGGCTGTCAACTTTAGCCTCCTTGGATATCTGCTATCAACTCCTCGGTTGGGTAGTGTCGTCTCTGCTACTGATGGTGGCAGCAGTGGGTGGGAGCACGGGGGCTTCAGAAGCTGCGGTTCTCCAACTACCGGCCGTTCGAGCCCAGACACTGGCTTCAGCCGAGCTGGCGGCTGACGAGCTTCTCCGGCATTGAAGGGGCCCATGGCTGACAAACTCCTCATCTGGGGGACACAAAAGGGACGGCCTCTGTGGTCCTCTGTCTCTGTGAACCTGGAGACCCAAATGAAGCCAGACACACCCCAGATCTTCTCTCAAGTGGATATTTCTGAGGAAGCAACCCTGGAGGCCACTGTGCAGTGGGCGCCGCCCGTGTGGCCACCGCAGAAAGTTCTCATCTGTCAGAAAACCTTTCCTCCCCTAAGTTCCTTTGGTCATGATGTTTATCACAACAACAGAAAGAATTCAAGGAACAAGGAAAAAAGATATTTGTGTTTGGTTTCATTTTCCTGTAGCTGGGGATTTAAAAAAAAAAAAAAACTGGAGGCGGAGGAGACGCCTTCAGGGCCCAGGCCCACAGGACTCCTGAGCACCGTGGGAGGCATTCCATCCGCTGTGTGCTTACTGCCTCCACTGTGCATGTGCAAATACTTGTGGCTGCTGAATCAGAGGAAGGAGCTTGGAGACAGGAAGAGTTTATACGCAATGTGAAGGTGACGAGGTTGAAGATCTCTATGAACTGATTGAAACTGTTAAAGGAAAAAGAAGAAATCAAGGGGTATCAGTAGTGCTATACTCTCGACTATCAACGTGGACGAGTAGAAAAATGTATGTAAACGACTCAATCTCCACCTTTAGCTTTATCTTTGGCAAAGAAACCAGA	356	367	361	372	11
2S43D:03849:14427	CCCCAATGTGTCCGTCGTGGATCTGACGTGCCGCCTGGAGAAACCTGCCAAGTATGATGACATCAAGAAGGTGGTGAAGCAGGCATCTGAGGGCCCACTGAAGGGCATCTTGGGCTACACTGGAGGACCAGGTTGTCTCCTGCGACTTCAACAGCAACTCCCCAGGCAGGATGATCATGTCCCTCAGGTGCGTCTTCACCACCTCAGGCTTCTCCATGGGTGGTGCCTCCTTTTTGGCCTTTCTCAAGCGCTTGAGCAGTGAGAAGAAAGGCAATAGTGCTGAAGCTAAAGGCAACCGAATGGCGGACCAGGCAGCCCGGGAAGCAGCCATGGGGACTGACACAAAGGCCTCCTCACTTCTCATAGAGACCTCAACA	469	479	166	176	10
2G5Z3:01441:09271	GACTTGTACATTGTTTGTTTTTTTTTTTGGTTTGTCTTTTTATTAGTCATTCCAAGTATCCATAAATAAGTGTAGTAATCAACCATTTGAACTATTCTACCAGCTGTAATCCTTATCATAATTGCTCTCCCCTCTCTACGCATTCTATATATAATAGACGAAATCAACAACCCCGTATTAACCTTAAAACCA	341	351	53	63	10
2S43D:03583:01985	GGGGTGTTGGTCCTTGGTCTCACGAGGCCGGCTCTAGGATGCATGCCTTGCAGAGGAAAGCTGCCTTGCTGGCTAATCTGACCCATCATAGAGTTAAACGATGGTGACTGTCCCTGAAGGTTAAGACGATGGGGCCAGCAAGAACAGGAGTCAGGCCACCAAAGGACAGGGTATGGGGTGAAAATACAGAGACCAGAGCTGGACTGGGCTGACCACAAGAGCCCAGCTTCGACGGGCCAGAGAATAGAAATTCTTACAGTGCCAACAGAAGTATTACAGTACAATTTTCCACAACAAAACTGGAGCACACAGTCCATGGGAATCTCGACTTCCTTCAACTGTCAACACACTGCACCCTGTATAAGTGGACTGATAAGGACCTGCCAGCAAACTTGGCTTTGCTGCCCAGCTCTTCCTCAATTCTGAGGATCTGATTGTACTTGGCCAGGCGCTCGGATCGGCAAGGGGCACCAGTCTTGATCTGCCCAGTCGCAGAGCCCCACCACCAGGTCTGACGATGAAAGTGTCACTGTTGAAGTCGCAGGAGACAACCTGGTCCTCAGTGTAGCCCAAGATGCCCTTCAGTGGGCCCTCAGATGCCTGCTTCACCACCTTCTTGATGTCATCATACTTGGCAGGTTTCTCCAGGCGGCACGTCAGATA	574	585	595	606	11
2S43D:01767:08921	CATGCCTCTCGCAAAGGATCTCCTTCATCCCTCTCCAGAAGAGGAGAAGAGGAAACACAAGAAAAAGCGCCTGGTGCAGCAGCCCCAATCCTACTTTATGGACGTGAAATGCCCAGGATGCTATAAAATCACCACGGTCTTTAGCCATGCACAAACGGTAGTCTTGTGTGTTGGCTGCTCCACTGTCCTCTGTCAGCCTACAGGTGGAAAGCAAGGCT	305	315	14	24	10
2S43D:09771:03039	GGCAGCTGTGCGTAAAGGCGCTGCTGGCTTCCGGAGATTTTTCTCTCCCTCCGTGGTCGCGCCTGCTTCTCGGCGTCCGCTTCCCTCAGTTCCCCGCTCCCAGCAGGA	238	248	1	11	10
2G5Z3:01778:13784	CCCTCGGCTCCTCCGGCGACTCCCCGTCCGTGCTCATGCCGCCGTCATGCCAGAGCAGGTTCGAGCGCTCCAAGACACTGGCGACGCCGCCACTGCGGCGGCGGGGCCCGAGCCTTCGACTCGGGCGTCCGCGA	104	114	35	45	10
2G5Z3:03567:01143	AAGTTAAATAAGGCAACGCTTAACTGAGGTGATCAAATGATTTTCTCATCCGTAGATGAGTGGGCTTTTAACCTTGGCTTGGGTGGACATGGACCCGATTCCTCCCCGTGGGTACTGGTAAAACCCACACATGTGGGCAGACCTTTACCTGTGAGCCCCTAGGCCAAGGCTGTAGCATTAAATGACTATTTATTCTTCTGCCCCCCTCTAGAGCACTCTTCTTGGCCAGACCCTCTGTCCAAGGCTCATTAGAAGGCTGGGGTTGTGTTCAGGA	46	57	76	87	11
2S43D:10241:04590	GGCGTATGTATCAGTCTCAGTCGGGGGTGAAATTCAGTGTGGAGCCAGGGATATAGAAAGTACCAGTTCCTTGCTGAAGGACATATCTTGACGCTAGAACAAAAAACAGATTTTGGGCAACACTATTTCAGTAAAGATCAAACTATGTGCAAAGAGTGGATATTATTTTTTTTCTTCTGATTATGAGGAGTCGTACTACTCGTCTTGACGTTGTCAGCATTATATTGTAATCTGTGCAGTAGCTAAAGGAGAATCCACACTGTTGCGGGGACATCCAAACATTCCTTGGTTTGTTCTCTACTGTTAAAATGTGTATGAATTTAAGTTGCGTGTTTAATAAAAGGCTACAGACGTAACTCGATCAACACAAGGAAACTATACTGCTTTAATACATTCTGCTGA	250	260	206	216	10
2S43D:05242:12330	GAGAGAGAGAGAGAGAGAGAGAGAGAGAGAGAGAAGAAGAGAGAGAGAGAGAGATGACATGCCTGCGCAGCTGGTGGACAAGGATAGGCTGGCCTGGACCCGTGCATGTACAGAAAGGTCCTTTTGGGCGGGAAGAAGGTGAGAGTTTTCTGGCCGTTGACTTGAAATATATTTTTGAGTTTTGTCCTTCATGTTTTACGGAATAAAAGTTTGGCA	235	245	63	73	10
2G5Z3:07440:12356	CTATATCAATTACAGAACTCTACTCAACTTAAACTTCATAATAGAAGCTCTACTTACTATCATTCAAAGTGCTGTCACTGTGTGGGTGGAGATAGCCACCCGTGCGGGGGGACCCGGCCAGTGGTCCGTCTCAATCTTTGGTATCTCGTTGGGATCTGGCGCCTGGGCTGCTGGGAACTTGGAAAACTTGTGATATCTTCTGAAGCCTTGCTCTGGGCTGCCAAGGCAGCATGCTGTTTGATAGATGACCCCTTCTTTTGTTGTGCTTCAGGAAAATCCAATTTTCTTTGGTTAATCTTGGATCGGTTCGGTGTTGAGTTACCTGAACATTCATTCTTTGTGGTCCCATGTTCTGATAAGATCCGTGGCCAGGAAATCTGTGA	49	59	82	92	10
2G5Z3:09529:01505	AATTTACACTGCAGCTTTCGTTTCTGAGTACGAGGCCCCCTCTGGATGCTGGTCTTCATTTTCTCTGTCAAGTGCACGACGTTGGACTGCAATCTCCGATATCAAATGGCTCTTCAAAGATGTAGGCAGCATCAGCTCCTGCTGCAAGAGTGGCTCCCCAGTGAGTTTGAGGCCACTGTGGTCTAAATAGTGAGTTCTAGGACATCCAGGGCTATGCAGAGAGATCAAGTGGGTTTGTTTGCTTACTTGTTTGTTTTTTAATGGCGGAGTACGACCTGACTACTCGCATCGCGCATTTTCTGGATCGGCACCTGGTCTTTCCGCTTCTTGAGTTTCTCTCTGTGAAAGAGATTTATAATGAAAAAGAATTATTACAAA	613	623	295	305	10
2G5Z3:05165:10357	CTACATACTGCAGGACACTTATTAATACACGGGCCATCCACAGTCTTCTGGGTGGCAGTGATGGCATGGACTGTGGTCATGAGCCTTCCACAATGCCAAAGTTGTCATGGATGACCTTGGCCAGGGGGGCTAAGCAGTTGGTGGTGCAGGATGCATTGCTGACAAA	183	193	6	16	10
2S43D:03956:06632	GCGGCAGCCGCAGCCATGAGCAGCAAAGTCTCACGCGACACCCTGTACGAGGCGGTGCGGGAAGTCCTGCACGGGAACCAGCGCAAGCGCCGCAAGTTTCTGGAGACGGTGGAGCTGCAGATCAGCCTGAAGAACTACGACCCTCAGAAGGACAAACGTTTCTCGGGCACCGTCAGGCTCAAGTCCACCCCACGCACCGAATAAGAGCAAAAAACACTGTTATTGACTACTGGGGGGCTACGGGCGAACCTACTTCAGTGTACATCTGACCCATAACCACAGAGTTGAAGTTAAAGTGAAGATCCCTGAAGAGCTGAAACCCTGGCTTGTGGATGACTGGGACTTGATCACCAGACAGAAGCAGCTTTTTATCTTCCTGCAAGAAGAATGTGGATCATTTTGGAGGATTTATGCAAATTATAAGAAGATCTCGAGGAAATACAGATAATAAAGAGGTGCTTTCAAGGCTTTTAACAACTTGTCTGCCTTCATGTTAGCCCCGGAGGCCCAGCCTTTTTGGCTAAATTTTTGCAGGTCGCTGTACTTAAAGGAGTCCAGCTCCTCTGCAGAGGGGACGGTCATCGCGA	522	532	173	183	10
2G5Z3:02265:13183	GTTGTCTGTACCCTGTTGTGGCTCTATAAACAGGTCTTAGAGCCTTCTTTTCGCCAGGCCTTCCCCAATACCAACCGGTGGTTCCTTACCTGCATTAACCAGCCCCAGTTCAGGGCTATCTTGGGGA	517	527	49	59	10
2G5Z3:07487:04318	CTGGGTTAGCCACCAAGTTGAGGAAGAACTTGGAAAATTTTTGATGTCATCGTCAAGCTTAAAAAACAGCTTTAAAATTCTTAAATTAAAAATGAATAAATAGCCAGACAACTTTCCTTCTAGGTTACTCTCAGATATGGTGTGGCATCCCATGGCTATGGCGGTCGGTTTGGAGTGGAGAGAGACCGGATGGACAAGAGTGCCGTGGGCCACGAGTATGTTGCTGATGTGGAGAAACACTCATCTCAGACTGATGCCGCCAGAGGCTTTGGGGGCAAATATGGAGTTGAGAGA	101	112	250	261	11
2S43D:03934:07221	CAGCATCCCCACCGTCGGCCTATGACCAGTCCTACCCAGTACCTGGGATCCATCCACCCTCAACATATGATATCATGGTGTAAAAAAAGAAACAACATGCGTGCAGACACACACACACACACACACACACACACAATCTCCTGTTGTATGTCCAAACTGTGGGAGTGACCACGTGGTTCTCCTAGCTGTGTCTGGGGAAGTCCCGAATAGAGAGCAGAACCAGGAAGAGCAGTCAGCAGATTCTGCCTGTGACCTCGCTGACCACGGTGGCTGTCCCAGCAGGCCTGATGGCATCCCACCTCAGACATCCATATCCCAA	590	601	69	80	11
2S43D:08368:12590	CTCAGGGTGGCAGTGCAGCCTCTGGCTGAAGTGTAGCAGTCATCTATACCGGCCATCATCAGGAGCTTCTTGGGCACAGGAGCAGAGACAATGCCAGTGCCTCTGGGGGCAGGGATGAGACGCACCAGCACAGAGCACAGCGGCCTGCCTCAGTGGGTAAGAGCACCCGACTGCTCTTCCGAAGGTCTGGAGTTCAAATCCCAGCAACCACATGGTGGCTCACAACCATCCGTAACGAGATCTGGCGCCCTCTTCTGGAGTGTCTGAAGACAGCTACAGTGTACTTACATAATAATAAAGGTGGTTCTTTTTCCTTGATTCCTTTTCATATCTTGAGCCAGACTTATAATGTGTTTTGGAATCTGTTTAGAGGTGCCTCTAGTTTTGGTGTG	141	151	302	312	10
2G5Z3:06781:03905	GTCAACATGCAATGCAACATTTTAGCGGAAAGATAAGCTGAAGTACACATTCGACCATGTTCATGGGATAAAATCTCCTGATGATTCTCTCAGTCTTACT	401	411	47	57	10
2S43D:09509:05657	AAATTGACTGTGTCCCGGGCAAGAAAGATACAGCGCTTCTTGTCTCAGCCATTCCAAGTTGCTAGGTCTCACGGGTCACATGGGGGAAAGCTGGTGCCCTTGAAGGAGACCATTAAAGGATTCCAGCAGATTTTAGCAGGTGAATATGACCATCTCCCAGAACAAGCCTTCTACATGATGGGACCCCGAAGCAGTGGTGGCTATGAACCCAGAGGCCGTGGAGGTGGCCGAGGAGGCAGAGGCGGCATGGGCGGAAGTGACCGCGGTGGCTTCAATAAATTTGGTGGTCCTCGGGATCAAGGATCTCGTCATGATTCTGAACAGGATAATTCAGACAACAATACCATCTTCGCGCAAGAGCCGCCTTCTGTTCCACTGCCGACTGTGACGCCGTAAATGGCTTTTCATCGCAGCCATGGTATGGAAATGCTTGGCACAGGCCCCACAACTGAAGTCTCCTGTCTGATGGGTCTGAAAGAGAAACCCAGCCCAGCTGTGGTCAGAAGCACTGATCCTGAAACAGCAAAAGAAACCAAAGCAGTCTCCGAAATGTCTGCTGAAATTGGGGCGATGATCTCAGTCTCCTCTGCAGAGTATGGCTCTGATGCAAGGAGTCTGTAACAGACTACACCACACCGTCAGGGTACCTGGCTAGGGTTGGTGACAGATTGCAGAGCCTGTGGGGGAGCGTTAGCAGACGGAGGAATCCAGTACATTGCTATTTCTTTCTGCGTGCATAAAATTGTATAGCATATTTAGAAACTGGATTTGTAATTAAGCAGGTTCAAAATGAATCTTCAGAGCATCATGATGCTTGATCACATGTCTCGATCCCAGTAGACGGTCTTGGGCTCGGCCATACA	547	559	566	578	12
2S43D:04675:13121	CCCACGCATTCTTCAAACTATACTCTTTATATGCTCTGGGCTCAATCATCATAGCCTCGGCAGACGAATCAAAGACCATCCGAAAATAAAGGAAACCAATCGAACCAAAGTCCAGTCAATAAAGGGTTAAGCGCACACAAGCGTGGCCAACTAGCAGGTCCGGGGGTTCAGCAGCAGGCACCGTATGCAAATATGCAGAGGGGTGGGCTTCACGCCTCCCCCGCCGAGTGCTCCCACAGACGAGGAGTTGGTGCGCAAGGAGAGGAGGTTTAAGTCCAATACTCCATCGTGGGCCGCCCTAGGCACCAGGGTGTGATGGTGGGAATGGGTCAGAAGGACTCCTATGTGGGTGACGAGGCCCCAGAGCAAGAGAGGGTATCCTGACCCTGAACGTACCCCCATTGAACATGGCATTGTTAACCAACTGGGACGACATGGAGAAGATCTGGCA	8	18	398	408	10
2S43D:09331:03253	CAACACAGCTCGCTATGTGGATCAAGGTGGAAACAAGCGCCCAGGCGCGTTTGCTATTTACCTGGACCTTTGGCACTTAGACATCTTTGAGTTCCTTGACTTGAAGAAGAACACAGGCAAGGAAGAACAGCGAGCACGCGATCTCTTCTTTGCACTTGGATCCCACTCTCTTCTATGAAGCGAGTGGAGACATAAACCAGGACTGGTCAATTGGATGTCCCAATGAGTGTCCTGGTCTGGACGAGTCTGGGACCAGCAAATGAGGCCAGCCTTGTTTTTTAGCCCCTTGACTCACTTTTGGAGATTTGGCTGGGGTAGGAAAGCCTTTAGGAACGAGGTGACTAGGTTAGGGAATGCATTAGTGTTTGGGGGGGGGAAGGAGAACGGCGCCTGGGGGCAGAGCCTACCCCCAAAGAAAAGGGTGTCTAAAAATGTTCACGGTTCCTTCATTCCGATAACGAACGAGACTCTGGCATGCTAACTAGTTACGCGACCCCCGAGCGGTCGGCGTCCCCCAACTTCTTAGAGGGACAAGTGGCGTTCAGCCACCCGAGATTGAGCAATAACAGGTCTGTGATGCCCTTAGATGTCCGGGGCTGCACGCGCGCTACA	431	441	128	138	10
2G5Z3:10210:05023	CAACACCAGGACCTTAGGACAAATGGGACTGATGTCATCTTGAGCTTTTATTTTTGACCGTGATTTACTTTGGAGTGGTGGCATTGGTTTTTTTAAGGAAAAAAACATGTCATGTGGGTTGTCTAAAATAAAGTGCGAAGGAAAAATAAGAATTAGCCCTGAGACTGCCAAGGCACCACGACGGGTAGTAGGGTCT	218	228	175	185	10
2G5Z3:02241:14011	CTCCACTTCGGCCTTCAAAGTTCTCGTTTGAATATTTGCTACTACCACCAAGATCTGCACCTGCGGCGGCTCCACCCGGGCCCGCGCCCTAGGCTTCAAGGCTCACCGCAGCGGCCA	365	375	61	71	10
2G5Z3:03309:04529	CACATACTCCAACGGTTTCCTGGTCCCTTGTTTCCAGGTCCCCAACTCCACTTCTTCCTCTGGCTGGCCAAGGACCTTCAGAGACACCAGCGTCTCATAGTTGCTTTCCATAACATTTCTGTAGAGCTCCTTCTGCCAGTCCTCCAGGTTCTCCCACTCCTGCTCCGAGAAACAGACTCCATCATTCATCAAACTCCGGCAACGCGCAAATCGGAAAGTGGCTCCTGACTCACGGGCCACAGCGGGTGGTGGATGGTGCCTTCAAGGAATCAATTTCGGACTACAGAGGGAAGTACGTGGTCCTCTTTTTACTAACCCGAACTGGACTTCACTTTTGTTTGCCCCACGGAGATCATCGCTTTTAGCGACCATGCTGAGGACTTCCGAAAGCTAGGCTGCGA	32	42	144	154	10
2S43D:09080:02946	GCAAGATGGCGGGTGAAAAAGGCGCCTGACAACAAAGGAGAAAGAAACCTGCGGCTGTAAACTTAATTTGCCTCCCTACCTCACACAAGAAGCTCGAGATCTGCTTAAAAAAGCTCGCTGAAAAGAAATCGCTGCTTCTCGTCTTGGAGCTGGCCCTGGGGATGCGTGGAGAAGTCCGAAGCTCATCCTTTTTTCAGACGAGAAGGGACTCGGGATAGCGTTTAGCACTTTGAACGTAGGAATTGCGATAATTATAGTGGCTGATGTAAAGTAAGCTCGTGTGTCTACATCTATCCTACTGTGAATATGTGGTGGGCTCATACAATAAAGCCTAGAAAAGCCAATAGACATTAATTGCTCATACTATTCCTATATAGCCGAAAGGTTCTTTTTTTTCCGGAGTAGTAAGTAAACTTACTTATGTGTGGGGCTGTGAGCTTGGCACAGCCTGAGGTACAATAAGCCCAGCCTGTGGTTTCAGAGTAGCCAGAGCTTCTCGAGCAGCAGTGACCTCTTTGGTGAGCCGGGCAATGGACTCGGCAGGCAGCATCGTGTTGGTACAGAGCATGGGGACAGCTCCTGGTCGGGTTGTCTGCAGTTGCTGGCGAAGAGTGAAGCTGTTGCAGCCATGAGATCCCACTGCACATAGGACTTATTCTTCTTACATGACAAAAAATTGCTCCCCTATCAATTTTAATTCAAATTTACCCGCTACTCAACTCTACTATCATTTTAATACTAGCAATTACTTCTATTTCATAGGGCATGAGGAGG	141	151	383	393	10
2G5Z3:04191:08126	GACCTTGAGAAGCTGAAGATCAGAAAGAGATAGGAACTGAGTGAGGTCACACAGTAGATGCATAGCACAGCTGGGCTCTGGCCTCAGTGCACCAGACCACAGCCCTGCTTTTTCATTTGGGATATTGTGTTCCACCTACGAGGACCTGGACTGACGCAGGGCATGTGGAGAGAGACTACTGCAGGAGCCTCCAGTGACACCATTCCCTGAAGCAGGCTTCAAAACCACCAAGAAATCCAAGATGGAGGGCTACAGGCAAAGGACAAGTGGATCTGGCGACGTGTGCTGACCCCAGAGATCATGCTCCCATCCTGCATGCAGACGTCAGAGCGCCTGCTGCCTACCTGCCCTCTGGGGAGGCTGGTTGACCTTTAACCCTGACTCCTGAAGACTAGAAACAGTAAGGCGGCGGGCGTCACCAGACGGAGAAGCCACAGGCACCACGAAGGGGCTATCAGGTATGTGCTCCTCGTTGAACTTGACTGA	392	402	340	350	10
2G5Z3:01932:02026	CCCTCCCCATCCCCATGCTGCCAACTTCTAACCAGCAATAGTGACTCTGTCGCTTGTCTGTTTAGTTCTGTGTGTAAATGAAATGTGGAAATTGACCTACCTGCCCACTGGGACATCAGCCTGTCAAGTGTCCATGATGCTGGGCCCTGAGGGAGGTGAAGGCTATGTGGTCAAACTCCGTGGCTACCTGGTCCTGCTCAATTGAGACGCTGAGTTCGAGGCCAGCCTGGTCTACAAAGTGAGTTCCAGGACAGCCAGGGCTACACAGAGAAACCCTGTCTCGAAAAACA	392	403	96	107	11
2S43D:08057:04696	AAAACTTAACAGTAGGAAAGGAGGAAAATGGCAGTTCAAAATTTGATGAAGTTTTTCCAACAAACGGACTAACTCTTCAGTACAAAATGGGGGTGAGACCACATTTATGGCTAAATTGTGCCCATGATGAACAGACTGCCGCTATGTTTTCACACTGACAGAAGGCGTATTGAAAATAATTTTGGTAATACTAAATA	600	610	22	32	10
2S43D:01108:05457	TCTGCGTGCACACTCTTGACCACAGCTCCCAGGAAAGTTTGTCTCTAGACAAAAGTCGTGACCCAATTTTACTCTGGTAAGGGCAGAAACGGTTCACATTCCATTATTTGTAAAGTTACCTGCTGTTTGCTTTCATTATTTTACACAATTTGGCCTCCACCCATGACTACCATCAGCAATAGAAGGCCCTACACCAGTTTCAGCACTACTACACTCAAGTACAAATAGTAGTTGCAGGAATTTTCCTACTGGTCCGATTCCACAGCTAGGGTCATCCCTTAACCTCTCTTATCCCAAGCCTCCAGCTACTTACCAGAGATGCCTGCCATGATCCGCCCATTCTCAACTCCCAGTCTCTTACCCACTTCTCTCCTCCTCG	559	570	54	65	11
2G5Z3:05098:06989	GTCTGTGTGAGTTCCGGGGGTGCTCTCCGCAGCAGCCGGGCGAAGTGACTCTGAGGCTGGGGTAGCCTGTGCTTTCCAGAGAGGCAGGGAAACGGGGACCCCGTCTAGGTATTCTCAGTCTCTCAGAAATGAGGAGTTCATCAAAGCAGAGAACAGCGGAAGAAACTGGTCTTCTTAGACC	288	298	37	47	10
2S43D:08111:13077	TGGGAACCTAGCTGATGATAGGGGGTTCCATCTCCTAACTTGTCCATTTTGTTGCATATTCTAAGGACCCAGACATAGGCTTGGTGGCCCGTCTCTTGTTTTTCCATGTGGTGGCGTGCGCAGGCTGCTGGTCGAGCCGAATGGTGACTGCGGTGGCTGTGCTCGCTGGCCGCTGGGCCTGATCGCTCGCTTGGTGCCCGCTCCGTCGGCCCCCTCAGACTGCTGCGTGAGTGTGGCTGACGTCGCTG	241	251	155	165	10
2G5Z3:09771:02647	CATTCTCCAATCCCACCGCCCTGAGAATCCTGCATGCCAAATCCATTTGCCATGACTATCCTGGCAGACCTCAAAGGAGTGGCTGGCCAGAGCTTGCCTTTGCTGAGCCCAAGGTAGGACGGTGTCACTCAAAGACTTCCAGTGTGAAGATCATATTAGTAAAAAAGGCAGAGGAATACGGAATTCTGCTCAGACTTTATCACTCGATGGGGGATTCTTCAATAGA	210	221	78	89	11
2S43D:10217:04322	GGGCTGCTGATCCGGGGGCTCATAGGAGTGAAGCCACCAACAGTTAAATTGGTCACATCCCGGGGCTTTGAGCCCCCAGCCAACACCAGGTGCCGTGCCTTACAGACAAACATGCCGCCGTTCTCCACCAGCTTCTTGCAGTCTGGACACATGTATCCGGTGTGGGGAGCTGACATGGCAGAAAGGACCTGATTGAAGAAGGGCCAGGGTATTTGCCAATGGTGAGAGCTGGACAGTGCCTATGTCTTCCTTCAATTCTGTACCGTATCCATCACCGCCTGAAGGAACAGCAGGAGGACTTTGCCGGCAAAGCAGCTCAGTACCAGAAGGAGGTGAAGCACCTACATCGGATGCTGCAGGAAAAGCAGGAGGTCCTGGATGAGGCGCTGCAGCAGAAAAGAAATATGGACTCCCTAGGAAAGAAGGGGTTGCTTTATGGATAAGCCTGTAGAATCGGCTGCTTCCTATGACTCCCTGGCTGCACAAGAAGAAATTGTCTGTCTTCCATATATGCTTCTAAGTATCCTACCTCTTTGAAGAAAAAGATAGGGATGGAGTGAGGTGACAGTGGGAAGGGACACAACTACATGGCCTTTCATGACCCTGA	90	101	451	462	11
2G5Z3:06291:05642	GTCCCGCATGTCCATCTTATCAAATTCATCAATACAACAGACACCATTATCAGCCAGCATCAACGCTCCAGCCTCAATGACAAATCTGAGATTGGCCCATCTTGTGTTCCAGGAGGCCCCCCCTTCCACTCTGCGATGTACGTTAGTCCCCCACTTGACTTGCGGATCAAGTGAGTCTCA	81	91	33	43	10
2S43D:01876:11760	TAAGTACCTGCCTTCACTCATTGCTGGAGCTGCCTTCCACTTGGCTCTCTACACAGTCACAGGACAGAGCTGGCCTGAGTCATTGGCACAACAGACTGGATATACCCTGGAGAGTCTTAAGCCTTGTCTTGTGGACCTTCACCAGACCTACACCTGGAACAGCCAGGACAGCAGACACTCATCAGCCTGAAGTCCTCTGAACTGGATGAAGATGAGGGTTTTGGTGACTGGTCCCAAAAGCCGGAGCCACGGCAGCAATTCTGGGGGAATGAGGGGACTGCAGAAGGGATCCAGTTCCTCACGCTTTGCTCTCTCTTCCTCCTCTCTTGGCTTTTTGTGCGTGCAACT	78	90	84	96	12
2G5Z3:00472:12662	CGCAGCTTGGCGCGGCCCCGCACTCGCTCCTTAAAGGCTTCCAGTTCATACTTGAAGCCCTCCATGTACTGGTGGTCAGCGGTCTTGATCTTGGTGAAAAACTGCCGGAAGCAGGCTCGGGGGATAGCGCCAATCTTCCTTGAGACTCTGCGCCATGAGAGCGAAGTGGCGGAAGAAGAGAATGCGGCAGGCTGAAGCGCAAGAGAAGAAAGAGTGAGGCAGCTGGGTTTGGATCACATAGCAGTGAACAAATGGATAAAAGAACTTTAGAAATAGTTAAAGCAGGAGACCACTGTGATCTTAGAATATCAAGACAAATGCTGCCATTACTGTTAATATTTGGATGATAAATTCTTGTTGTAAAAGGGTGCGTGTGGGAGGTAGCGTGAGTGGTGGCCGTCGGGTTGCAGTATTTTGGTCAGATGTGTCCTACGAGGAGCACTGGGATTTTGCAATTTAGCTCAGCGCAAAGAAGAGCGCCAGGCTCACCTCACTAACCAGTATATGCAGAGGATGGCAAGTGTACGAGCTGTGCCCAACCCCGTGATCAACCCCTACCAGCCAGCACCA	519	530	477	488	11
2S43D:02767:03720	TGGGCTGGAGCGAGCAGGGACTGGGCACACAGGGTTGACCGGAGTGAGCAGAGGTCCTAAAAATCTAATTCCCAACAACCACAGGAAGGCTCACAACCATCTGTACAGCTACAGTGCACTCACAT	73	84	18	29	11
2S43D:07166:01235	GGCGAGTGTCCACAACTTCAGTCTTCATTTTTCTTGAGTTTCATGTTGTTTAGGAAATTGTATCTTATATCTTGGGTATCCTAAGGTTTGGCTAATATCCACCTCAGTATAGAGACAATAAGCCAAGAACAGAACATGTGCCTTCAGGACCTCTCAGACAACGAGAAGAAAGCGAAACACGAAGTGAGAGTTCTGATTTTGAGGATTGTTCCCAAAAGAAGGCGACAGAGGGGTTCTGAGACGGACACGGACAGTGAGGTTCATGAAAGTGCGAGA	413	423	169	179	10
2G5Z3:09141:03299	CGAAAGCGAAGAACGGAAGCCTTCCCTTGCCCCTCCCAAAGCCGAAGCCAGGGGACGGTTGGACCGGCAGATTGGAGAGATTTGAATTGGAGCCAGGGAGCCCTCGAGACCTACCAGGGAGGGGCTGGTCCCTGAGACTGCCAGCACACAGGGATAGGATCGTAGGAACAACCAAGGTCAGAGCATGACTTACACTCCAGGGTGTAGCTGGTGGCAATGACAGACTCTGCCCAGGCAAGCAGAAGATTTAACCTGGGGATCTATGCATCCTGTCAAGAGGGTGGGTCCCCATCCCCGTGTGTGGAAAGAGACAGTAGTGGCTTGCTGCCGAGGCTCAGGCCGAGGTCTGGACAGCTCTCACTCTCCTCAAGCCAGGACTCATCGACCAGCAGATTCACCCATCAAAGGATGACAATCAACATTCCAATGCATCTCAGTCCCTGTGTGACATCATCCGCCCTAGCCGCGAGCAGGATGATCCCAAGGCCAGGACAGCCCTGGAGCCAGACCAGCTGTTGGCCACCTTGGAGAAGCAGGAGAACCATCCTGCAGGCATGGGTTATACAACCACACCAGAGTCAGACACTGTAGAACAGATTGGAAGAGATAGATACTGTGCACCTTTGCTTTCCTTACAAGGAACGATTTTATAATTCTAAGAGCCTTCCGCAACATCCTGTATTACTCTGCTTAATGTAAGCAAGCTAACATTTTGAAACTGGCTCCTGTGGCTGTGGCCGTTTCTGCGATCTGGACGGTAGAGTGCTTTCGGAGACTGGGGGTGGGGTCCGAGGGGCGGGGACGCAGTCTACATCTCCTGGGCTTCCGGCTCCTTGCTCGATCCCGTTGCCATGGCGCCGCCGAGCGCCGGACGTTGCTTGTGGCCGCCTGTCCCGAGGACAAGAAGATGCCACCCAGCGCATAGCTAAGAGAGGTCACCCCCAGAAGATGCCATCC	469	479	470	480	10
2G5Z3:02991:02760	TGGAGATATACAAAACCTGAAGAAATGGAGTCTGTGCTCAGGTCACACAGGGGGGCTTCAGAGGATCCTTATGAAAGATGAAGTTAGCTGATCTTTCACACCAGATAGATGTGTAATTTTTGATTTGGCTAGTGCAGTGTCTTCCAAGTCTTTCATTCATTGCTGTCGGACGTCTGCTCCTGCTGTCCTCATTCCTGACGGAAGTGTGTGATGCCCACATCTGTCTGCTTGGACCACCGTGAGGTCAGACTGGGGGGATAAGGCACATGGCCCATCGAGAGCATGCCAAGCCCACCCAGCTCCTTAGGGGTGTAGAATACAACAGGCGAGCAGCCACCTCAACGTCGGTATCGCCGAAACTTCAATTACCGACGCAGACGCCCAGAGAACCCTAAACCACAAGATGGCAAAGAGACAAAAGCAGCCGATCCACCAGCTGAGAATTCGTCCGCTCCCGAGGCTGAGAGGCGGGGCCATGATAAAAGGTGCCGGCTACCATACTACCATCATCCGTGCCAGCTTTCTTTTCAGAATCAAAATGCAGAACAAATGGAAAATTTTATGGTATTTAACCTTCACAAGTTTGAGCCTCCACATATAATGCAACCAAGTTTACATTTTTTGAACACCCTCTGCTGCTACAAACTCTTCCAAGAAGATGAAGTTCCAGGGAGAACCCAAGGAAACCTACCTATGAACGGTTTACCGAAGTTCTCCCAGGAGCTGCTGTCCAATTGGGGAGCTAAATCACCTGCCGCTGAAGGAGCGCATGGTGGAGATTGGCAGCCGCTGGCACGCACTCCAGAGCAGCTTGCTCCTGAGCCACACTCGAGGGCCATGGGCATGGGCACTATGGGGATTTCTACCCCTGGCCTGCCAGGTGTCCAGGGACTCTTGCTAGCTCACCAAGGTTTT	325	335	810	820	10
2S43D:00087:09269	TGGATGTTCTTCTCCTTCAGGCTGGCCACAGAAAGCCTGAGAAAGTGCCTTCTGCCTTGGTCTCCAATCACAACTTATTGAGCTGAGACCACACGCTGTCTCCCAAGGCAGAGAGCAGTTTCCATCCTG	212	222	19	29	10
2S43D:02613:09546	GCCGTATTCATTGTCATACCAGGAAATGAGCTTGACAAAGTTGTCATTGAGAGCAATGCCAGCCCCGGCATCGAAGGTGGAAGAGTGGGAGTTGCTGTTGAAGTCGCAGGAGACAACCTGGTCCTCAGTGTAGCCCAAGATGCCCTCAGTGGGCCCTCAGATGCCTGCTTAAGTAGCAGCAGCAGCAGCAGCAGCAGTAGCAGAGCAGCAGTCATCTGGACCACCTGATGTCATCACTCCATAATATCATCCGGTCTGCCCTTCTACCAGATCAGCGATTCGGGCTTCTCCTCCTACCTTTCCCTGAACCAGGGCTGCGGGGGTAGAGGTGGAGGTGGGGTAGAGACTGCGGGGAATTGGCACTACAGGAATAGGAATACAGTCAGTGGAGCAGGGTGGCAAGTGGTGGTGGTGGTGCGGTGTGGTGCCGGTGGAGACAAAGGA	574	585	159	170	11
2G5Z3:05951:02362	AGAAAAACCAGAACAACCCGACGCAGAGATAGATCTGGATCATCTCAGTCAACATCTCGAAGAAGACAGAGGAGCCGGTCTAGATCACGAGTTACTCGGAGACGGAGGGGTGGCTCTGGTTACCATTCAAGATCACCTACCAGACAGGAGAGTCTCGAACCTCCTCTAGACGCAGAAGAGCCGGTCTTGTCGATCAGGATGATCTGGACGAAGAGCATCAGGGCTCGCGCCAGCCGAACTGTTCGCCATGCAGTCACTGTAATTCGATAGGGGACCCCTCCTTTGAACTCCCCTGGTAACAATGTGCTGAGGTTTCCAGGGGGGAGACGGGTCCAGTTTGAGCTTGTCCAGGCTA	453	498	178	223	45
2S43D:01759:12661	AAAATGGCCGCTTTTCTGGATTCATCGACTGTGGCCGGCTGGGTGTGGCGGACCGCTATCAGGACATAGCGTTGGCTACCCGTGATATTGCTGAAGAGCTTGGCGGCGAATGGGCTGACCGCTTCCTCGTGCTTTACGGTATCGCCGCTCCCGATTCGCAGCGCAGAGACCCACGTGTGGAGAGATGGTGTGAGTCACAGTCACTAGCATGTGGATAATCTGACCATACAGTGGATGCACAGCCACGTTCACTGTCTCATTTGTTTCAGGTATTTCAATTTTTAGAGGTAGGGTCTCACTGTGTAGCTCAGGTTGGTCATAAACTTTCTGTCTTCTTTGTATACTAGGTGCTGGACGCGTGGGTTAATTCCCACATGAGGAACTGGCAAGAACTCACAGCAGCTTTGACATTGAGTAACAATGTCACGGGCTTCTTTTCTTGTCAAGGAGAAACGACTGCGTAATGTTTCAGCCGTCACATGAAAATTATTATGAAAATTCTGCAGCCTCTACCGGGGACGCAAGATGAGGGTGAATGTGGACCCCGAAGACCTCATCCCCAAACTCCCTCGCCAAGAGACCTCAGCTTTCCCTGTGTGCCAGGCCCTCGT	602	648	0	46	46
2S43D:00469:12031	CCCAAGTGCTTTGGCCATATTTCTCACAGCAATAAAAGCAAAACTACGGAGGGACCCAAGCAAGGCAGGCCCTGAGAGGAGGCATCAGCTCGGAGTAGATGGGCCTGGATGGAAGCTGGACCCCAGCATTCACATCACGAGCCAAGCGTCCACAGACACCTCTGACTCCAGTTCCCAGGAATCACCTCTTCTTCTAGGCCTCTGATGCACAAAAGCTGCCGTAGGAAGTTATACTGGCACATGATGGTGAGGAAGAATCCCACAGAAGCCCTCGACTGTCATGGCCACCAGTCCCACGTGTGACAATGTCCACTCGAACGGGACTCATCTTGTCAACTGCCAATCTTGGCGTAGTTATTCGTTGTATGTGACTCATTGTAGGACCATCTCCATGAGCCA	446	456	106	116	10
2G5Z3:10274:09142	CACTTACCATGACTTTGTGAAGCCACACATGTAGTCTTATAGTACAAAATAAATTTGTAAAAAAAAAAAAACAAAAAAAAGGGAAAAAGGGGGCTGTTACTGGCCTTTGGGGAAGCTCTGAGGTGAGGGGTAGTCAACCTTCCCACTGCAGAGGTGTGGCCACAGGGTGAGAGAGAAGAGGAGAGCACCTGGCTTTGGTCACAAAACTCAGGGCCTGGCGCTAAGCCAGGACAGACAGACGGAAGAGAAGCCTCAAAACCACCCTCCAGGAAGCAGCACTACCTGACCAGTTCCACTGTGGACCTCGGCTTCTCGCTGTCTGCTCGCGCCCTCGTCCTACAGCACAGGCCTCCCGGCTCCGGCTCCGGCTCCAGTGTTGGTTGGGTGGCAGGCCTGGTGTGGTCTCCAAAGCGACTGGAACAATGCAGAAAGTACAGTGGCCCATTCGATGCTCCGTTTGCGTGATATATATCGGATTAGTCACCCGTAATTTACGTCTTCGACAAATGTGTGTTACTGATGAAAAGGCTGTTATTGTAATCTGATGTGTAGTGTATGGCTAAGAAAAGACCTGTAATGATTTGGACTATTAGGCAGATGCAATTCACTCATATGCTGTAATTCTGACACATGTGCATCTGTTGCTCTAAGTCTAGACACAGAATGGCTTCCCAAATGTGGACGTGTCTTGCACTAGTTAGAAGGCAATTTTATAAAAAATAGCAGGAGCAAAACTGGACATTTTGCTCGA	398	408	439	449	10
2G5Z3:06881:10382	GCCGAACTGTTCGCCAGGCTCAAGCGCGCATGCCCGACGGCGATATCTCGTCGTGACCCATGGCGATGCCTGCTTGCCGAATATCATGGTGGAAAATGGCCGCTA	554	614	44	104	60
2G5Z3:04038:04848	GCCAGGCTCACCTCACTAACCAGTATATGCAGAGGATGGCAAGTGTACGAGCTGTGCCCAACCCCGTGATCAACCCTACCAGCCAGCAGACCAGGCCTGCAGGGGATGGAACCTTCCAGAAGTGGGCATCTGTGGTGGTGCCTCTTGGGAAGGAGCAGTATTACACATGCATGTGTACCATCAGGGCTGCCTGAGCCCTCACCCTGAGATGGGAGCCTCCTCCATCCACTGCTCCAACATGGCGACCTTGCTGTTTCTGGTTGCCTTGGAGCTGCAATAGTTCACTGGAGCTGTGGTGGCTTTTGTGATGAAGATGAGAAGGAGAGGGCAGGTTGACATAAGAGGCCTCTGTGAGTGGCTGATGGTCAGCCCTGGGATCGGTCACCACTAGAAGCCGTGGCTCCCTGAAGGCTGCTTGGATCTGGTTAGTGAAGGTCCCAGGTGTGAAGCGGCCAGCGATCGGAGTGGCTCCTGTGGCAGCAGCAAACTTCAGCACAGCTCGCTGGCCAGTGTCCTGGAGGAGATG	520	530	0	10	10
2G5Z3:07310:10082	GGCCATTCAATCGGATATCTCATGGCCTACAAGGAGTTTATTCAGTTCCTTTAAGAACTTAATGCAGATCAACCAATTGAGCTGACGTGACAGTGATAGGTTCTGGCCCTGGAGGATATGTTGCTGCCATCAATCTGCCAGTTAGGCTTAAGACAGTCTGCATTTGAGAAAAATGGAGACACTAAGAGCTCAACTGGACCCGTCTCCCCCCTGGAAACCTCAGCACATTGTTACCAGGGGAGTTCAAAGGAGGGGTCCCCTATCGAATTACAGTGACTGCAGTATATTCTGGAGGATTAGCTGCTGCACCCTCAGTTTGGGATTCAGAGACCACCTTTATGGTGTGCTACGATACCTTCCTGCTCTGCAGTACCAGCAGCCGACATCAGTTCTGCTTGAACCATATCCCCACAGAGCCTCTACCAACTGGTTCTGTGAGGGACATAGCCCTTTACCCTCCCTATCAGTGACTGCCGGGTTCAGCCAGCCCTCTGTCCTGAGGCCAACAGAGCCTCACATGCATGGCCCCAGCCACCCTCTCCCACCTGCACTGGGAATTCAGGGGCCTGCAGAAGGAAGAAATTGTTTTACTTACACATGGAGACAGTGTAGACAAAGTTGCTGATGGATTCAAGGTTGTAGCACGTTCTGGGACATCTGTAGCCCTTTTTGTCACCATGATCAAATTATACAATTCTCTTCATGATATATACACTCAGACCCAAACATCAATCGAATTCATTAAATATCTTACTACTATTCCTGATTTGACCATGCTTATCCTCAATCTCCCAGTAGTGTGTGTGGCAGTTGCTTGGTAGTAGAAACCTTAGTGGGGCCTGAGTCCCTGCCCGTTGGCCTCTGCCTCTTGTGGTTCCTGAGAAGGCAGTAGAACCTGGACAGTTGCCCACCCCTCTTGTTTTGATGGCAAGATTCCCAAGGGTAACTCATTTGATGCCAACACGCCACACCAACAATCCTGGTGCTCAGTATACATGACCACACTAAATCCAATGAACCCCCTTGTAGTTCATTTCCACTCTGTTACCCAGTCTGTCTCTGACAGGTCGTTTCCGCTTGAGGTGACCTTGCCCATTCTCGTCTTCCTTGACCCTTGGTTTTTGTCACCATGCATCTATTCATCTACGAATCTTTGTCTAATTCCTTGTGTACTCTTGAGATTCCTTCTTAGCAAGA	145	155	665	675	10
2G5Z3:06049:03270	GTCTGCTAAGAAGTTTGGGAAACTGCATATAACAAAAATGCACTGTGGGTATTTAGAAGATAAATTCAATATGTATGCTGCCTTTGCCTTGGGAAGACAGGGCAAGAGCTGATGGGACTGCTGTTTCCTGTAGCACCTACAGCAGCTGAAGTGGAGTTGACTCAAGCTCCTCAGACTGGAGATACACCTTCCACAGACAGCATCTGAGGCCGCCTTCAGTGTTGTGACTGCATGGTGTGAGGCAGTCCCTCTGCATCTCTTTGTTCTGACAGTGCTACCAAAGCTGGCCCCATTTGGAGCAACACACTTCAAGGGCTCAGGAGCCAAGCCCTCAGACACAGCATCGGAAGCTACTCGTCCAGCTACCTTGAATCGCTTTTCTGCTCTTCAACAAACATTACCCGCAGAGAACACTGCCTTCATGACCTTGAAACGATCAAAGTCTGTCATCTTGGCTTTCCTTTCTCTGGCATCAATTTTCTTGGCCCATCTTGTGGCTGCCCATTTCGTATTGATATCCGCCA	610	620	373	383	10
2S43D:06207:13207	CTAATATCCACATTACTATGCTGGAAGGCATAGTATTATCCTTATTTATTATAACTTCAGTAACTTCCCTAAACTCCAACTCCATAAGCTCCATACCAATCCCCATCACCATCTTAGTTTCGCAGCCTGCGAAGCAACTGCAGGACTAGCCACTCCGACCCCGCCGCCGCGTTCGAGCTGAGCCCTTGCAACTTCGTCGTTCCGACCGCTCCAGCGCGCCACCGCGCCTCGCCCGCCGCCACCATG	182	193	135	146	11
2S43D:06199:12811	CTCGGCTCGTCCTCGCCGGCCGGGGAGAGGCCCCGGCCGCACTTCGGGGACTCCCGCTGCTCAAGATGCAATGAGGTGACAGATTATGCTATTGCCAGGCGCATAGTAGACTTGCATTCAAGAATTGAAACGGATCTTCTTCTTTTTGTGGCTGTGGACGCCTTTCAGCACCGCCTTCTTAGCTTTCAAGCCTTCGCTTTGGCTCGGCTTTGGGAGGGCGGAGCTCCTTCTTCGCTTTCGGCGCCA	143	153	139	149	10
2S43D:07301:00624	CAGTGGATGGAGCATTTTGAAACCTGGCCTGCCACCTCCCATTGTGGCCCATGCAGAGCGGCAGAGTGTCGCGCGGTCCTCGATGGTGGGCCTCAGCTGCCCAGCGCCAGTCGCACATAAGGACTACCTATGTGGGTGACGAGGCCCAGGAGCAAGAGAGGTACTCCTGACCCTGAAGTACCCCATTGAACATGGCATTGTTACCAACTGGGACGACATGGAGAAGATCTGGCA	8	18	182	192	10
2G5Z3:06282:11239	CCTTATAACTGACACACAGTGGAACTTGTGGGATTTTTATATATATGAAGGAGTTGTTCATGGCAGCTCGCTCTTTCATCTTGTCAATATCATCAACTGGGTGCTCAGGTAATTTGCGAAATTGATTCTTGTTTTTGTTCCCATGTTAAAGATAAGAGTAAATGCAGTATTCTCCACATAGAGATATAGACTTCTGAAATTCTAAGATTAGAATTACTTACAAGAAGAAGTGGGGAATGAAGAATGAAAAATTACTGGCCTCTTGTGAGAACATGAACTTTCACCTCGGAGCCACCCCTCGGGTTGCTTCCTCAGAAATATCCACTTGAGAGAAGATCTGGGGTGTGTCTGGCTTCATTTGGGTCTCCAGGTTCACAGAGACAGAGGACCACAGAGGCCGTCCCTTTTGTGTCCCCCAGATGAGGAGTTTGTCAGCCATGGTGAACATGGAACCAGGGTGGTGGATATGGTGTGGAGGAGGAGGCTATGATGGTTACAATGAAGGAGGAAATTTTGGTGGAGGTAACTATGGTGGTGGTGGAAACTATAATGACTTTGGAAATTATACGTGGACAGGAACAATCAAATTATGGACATGAAGGGGGCAGTTTGGTGGAAGAAGCTCAGGCAGTCCTCCAGTACAAGTACGAGGCTGGCGAGATCCGATGGGGAGCAGAAGGCCGCGATGATCTGTGCCACCAATGGGTCCAGTCAGGTGAGTGAGGGGCCCCGACCCGGACCCTAATCCTGCCGTCAAACCGGAACAA	548	558	682	692	10
2S43D:00100:08294	AGAATAATGACATCAGGTGGTAGGGTGACGAGTCGGGGCAATTAGACCTTTTTATCTACCTGGAAGCTAGCTCTGGAGATGTCCTGCCACTTGGCAGGATCTTCAAGGGCCATCGCTAGCTCCCATAGAAGGCCTGATGCTGTTCTACTCTACAACACTGGGGATCCTGCCTCCACCCCTTGAAGGTTTACCCTTACAGATGTGCCTGGCCATGTGTGGATTCCTTCCAGAGGTCATCTTCTCCTCCCCCTGCTCGCACACCAGCTTACAGTGATGCTCACAGTAAATCGTTTTTCTCGTTATATTTACTTGGTTGTGGGTTCAGAGGATTGGGACTAAACTCAGTCTCCGA	302	312	92	102	10
2S43D:10089:02828	GTGATTCATAAAACGAATGTTGATAGAGACTGTTTCTCTTTAATCGACCTGTCTCTCCCACGAGCACTGCGGCCAACAGGGAACGCACCTTCATCTGAGGGAATGGGCTCCTAATGGTGGAAATTCAGGAATTAAGGAAGTTCAGTTGAGAATGTATTTTGGAAGAGAGCAGAGTTGCAAATATCCATCTATTATGCTTTTGTATT	595	605	113	123	10
2S43D:02412:03531	CGAAAAGGGAGAGTCATCTGGCAAGAATGTCACTTTGCCAGCTGTGTTCAAAGCTCCCATTCGACCAGATATTGTGAACTTGCGTT	399	411	55	67	12
2S43D:06082:07379	GAAATGCTTTTATACAGACTCTCTGCTAACTGACAAATATACCTAAAATCATTTCCATTGAACATAAAAGGAGTATGCCAAATTTTATATAAATTTTCAGGTTCTGTAAGCTTTCTGGGTTTAGGCTACCTTACTCTGTTTATCCCTGGGCTCTTTAAGTGGAATTCTCACCTGTCTCCGTCTCTTCCTGTTATATAAAATGAAATGATGATAATTAGGATGACAAGTAACAGTGAAACTAACCCTCCAACGATGGAAGGATAAATGTTTATTGGTTCCACCATCAGTTATGATCAGCCACATTCGTCATCTTCATTCACCTTTCACTCCTCATCTCCTTCT	8	18	54	64	10
2G5Z3:08797:04340	CGCCGCAGTGACCACCAAGTCAGAAAGGCTCATTTCTTGGCTAACTTGCTACAGACAGCCTGCAGCGTGTGTTAGTGTGCACTGGTATCTGGACCCTCGATTCTTTCCATCAATGAGCAACAGCGGCATTTTCCATGTAAATGTATGTGGTAAAAGGCCTAGGAGATTTGTTGATCCAATAAATATGATTAGGGAAACAATTATTAGGGTTCATGTTCGTCCTTTTGGTGTGTGGATTAGCATTATTTGTTTGATAATAAGTTTAAACTAGTCAGTGTTGGAAAGAATGGAGACGGTTGTTGATTAGGCGTTTTGAGAAGAGCATCGTCTTTTATTTCATCCCCCTTTGGTCAACCAAAGGTGACAAACCAGTGAACCATAAAAACATTTTAGTTTGACTAGGAGGTGTGGCACACGGCCTTTACTCTCCTGTCTGCGACTCCATCTGATTAACCCAAGACTTGTAAAATATCCACAGGGGTTCGGTTTTGATGTTGAGAGACTTGTCATCCATAATTTCCCTTCACGACAGGGGCCAAGGATCTGCCGGAGGCATTCTGGCCCCGGGCACCACGTGAACTTACAACCCTACTCCTGTTTTTTTTTTTTTTTTTACATACACATAACTCACATGCAACTGCAAACTGTACTCATAACTAAAAGCATAAAATCTTTTAAAAGAGGCAACCAGTAAACAAAACCCACTAAATTCATTCTCATATGAGAAGGTTAATTATTTTTCTAATA	406	416	9	19	10
2G5Z3:10438:04877	CCCATGTCTGTCTGCTGCCTGCTCTGACTCTGTTGGCTTTTTCCCTCGCCTCTCCCTTTTTCTTTCTTCCGAGCCTTTTGTTCTTTTTCTACATGCTATCAAGTGATTAAGATAGGGCTGGAAAATTCTAGAGGAAATTCAGGACAATCTATCAGAAGTAAAGCGGGGGGGCATTGTGGGATATGTTGAGACCCCCACGAGGCAGTTCTTTATCACAACAGTTCCGACTCCTCATCTCGGAACGGGAAACATGCTGGATATTTGGTTCAGGTACATAAAAGGACTTAGGTGTGGCAAGGACGCTTAAAATGTAGAAGACTTGGTCTTCGGGGTTTCGTTGACTTCCGTCTTAGAGGTAACATTCTTCTTTGCTTGGGACGAAGCCTCTTCTGGCTGCTTATCAATGTAGATGAAAGTGTACTGCTCTACTCTTTCAGCCTCCACCTCACCACCAAGCCACCTTCACCCTTAGGTTTGGCCCAGCCA	407	417	447	457	10
2G5Z3:04512:07555	TTTCAATACCTCGACAGATTTCCACTAAGAATCAGTTCTTTCCAGTTGAGGCTGGTGGTTCACACATATAATCCTAACAGGGAAGAGGCCAAAGGCAGGGACAGTTCAAGCTCAAGGCCACTCAAGAAAACTGTGCTATCTTGGCCTCTAACATATTAGTACAAACTGTCCTAATCTGAGAGAGAGAAAGTCCTTTTGATTTCCATTTGACTGCTTTCTATGAGCCACGCCTCATCTTCCCTGTGCACATGTTTACCTGACACAGCAGTGCTGCGTGTTGTACATACTTGGAAACAACAAACTAGAAAATACTGTACTTCTGTACCAATCTTTCTTCAGTTGTGGTCTTCAACAGTTAGCTGGATTCCCGCTGGACGGCGTCCAACTCATCCATGCCTCGCTGAGCACGCAGCACTACGCTGTCTGCTCAGAGCATCAGGTCAGAGGCTATCCAACTCTGCTCTGGTTTCGAGATGGCAAGAAGGTGGATCAGTACAAGGGAAAGCGGGACTTGGAGTCACTGAGAGACTATGTGCAGTCCCAGCTGAGCAGGGTTCCA	486	497	429	440	11
2G5Z3:01921:08131	GAGGACCTGTATCCGCCCACTGCAGGACCCGACCCTGCCCTCACAGCTGAGGAATGGCTGGGTGGTCGGGATGCTGGCCCCCTCCTCATTTCCCTCAAGGATGGCTACGTGCCCCCAAAGAGCAGGGAGCTGGAGGGTCAACAGGGGCCTGGACAGCGCTCGCAGAAGAGCTAA	183	193	18	28	10
2G5Z3:01943:07874	GAAAACACACCCATTATTTAAAATTATTACCACTCATCATTGACCTACCTGCCCATCCAACATTCATCATGATGAAACTTTGGGTCCCTTCTAGGAGTCTGCCTAATAGTCCAAATCATTACAGGTCTTTTCTTAGCCATACACTACACATCAGATACAATAACAGCCTTTTCATCAGA	392	404	44	56	12
2S43D:02280:07351	CAGAAGATTAGCCTGGCAGTGCTTCAAGGCGTTTGGGTGGTGCGTTGAATGAATGGTGGTTTTTAGAAGACAAGAGCTGTTTCTTACCCGTCCGGTTAGCTTCAGCCTCCTACAGGAGAGGCCATGCCGAGACCCCGCAAGAGGCAGACTGGGACATATCAATTGCAGCAAGACAGTGAGAACTGTACCTGTGGCGAGTGTGTGGAGCTCGTGCTTGTGCTCGGAGCGTATGCCGTCCAAGGGTCCGCTGCAGTCCGTGCAGGTCTCGGACGCAAAGAAAACAGCCCACGGGCTGTGGGACCCCAACTGCAAAACGGGGGAAAATTGGGGCTTCCATCAAGGTGGAACGGACCGTCCCCTGGAGATGATCGAGCCGCGACACGCTGCAGTACAAGTTACTGGAGACTCATACAATAAAGCCTAGAAAGCCAATAGACATTATTGCTCATACTATTCCTATATAGCCGAAAGGTTCTTTTTTTCCGGAGTAGTAAGTAACTACATGTGAAATAATTCCAAATCCTGGGAGGATAAGAATATAAACTTCTGGGTGCCCAAAGAAATCAGAACAGATGCTGGTAGAGAATTGGGTCCCCTCCTCCAGCGGGATCAAAGAAAGTTGTGTTTAGGTTGCGGA	141	151	470	480	10
2S43D:04698:13096	GTAGACATCAAGGGAATGGGCACTGTTCAAAAAGGAATGCCCCATAAGTGCTACCACGGCAAAACCGGAAGAGTCTACAATGTCACCCAGCATGCCGTGGGCATCATTGTCAACACTCTCCCATGGAGCAGCCGGAGTAGGGAGCCAAGTACTGAAGCGGGGCAGCCGATCAGAGGCAGAGGCTGACACCACGGATGGTGTGACTTCATGCACCGCATCGT	259	270	150	161	11
2S43D:09381:06904	CGCTGCGAATCGGGAGCGGCGATACCGTAAAGCACGAGGAAGCGGTCAGCCCATTCGCCGCCAAGCTCTTCAGCAATATCACGGGTAGCCAACGCTATGTCCTGATAGCGGTCCGCCACACCCAGCACTCGGCTGCTCCTCTCCATCAGTATGATTCCACCTGGCCTTGCCCTGCCGCCTCGCGTAGCTGCTGTCAAACTCCGTCCCATCTTCTAGCTTTCCCGTGTAGTGCATGTGTAAAGACATCTCCCCTTTCTAGACTTGATAGGACCAGTTGGGTCCCA	92	102	128	138	10
2G5Z3:01661:07176	CCTCCATGATGATCTGGTCCTCCTCCAGTTTCTTCAGCTTGGCCTCGGTGGTCACCTTCTCAAGCTGCAGCTTCTGCCGGGCGCTCTCCTCCTCCTCCAACTGCTCCTCAAGTTCCTGATCATGATGTTGAACACTCGGTTCAGCAACTCCTCATATGTGTAGTCTCTTTCTGAGCTGCCAGCAGTTGCTAGCTGAATGAAATGCCATCATCTTTTTTGCTGTCTTCATCTTCA	472	482	7	17	10
2S43D:08143:10064	CGCGTCACTAATTAGATGACGAGGCATTTGGCTACCTTAAGAGAGTCATAGTTACTCCCGCCGTTTACCCGCGCTTCATTGAATTTCTTCACTTTGACATTCAACTCCGTGCCTGCAGCTCATCCTCCAGCTCCTCCAGCTGGGTCTTCATCTCCTCCACCTGCTGCTCCAAGGCCCGCTTGGACTTCTCCAGCTCGTGGACACTCTTGCCCACGTCATCCCCATCTCTAAGCCATCCTTAAAGAAAATCATGAATGGAGTCACACCATCTTCACGGTAGTCCAGGAGAGCAACCATACCATCTGGATTCATGTTTTCACCAATAAAAAACTGGTAGTTATTGAAATTAGCAAGGATGTGCTTAATCTGCTCTGC	616	627	301	312	11
2G5Z3:04587:06944	GAGACGGGAATCGATGACATTCCGGATGTGAAAAATGACTTTGCTTTCATGCTCCATATGATAGACCAGTATGACCCTCTCTATTCCAAGCGGTTTGCAGTGTTCCTGTCTGAAGTCAGCGAGACGGGAAGGTCATGGTTAACTCCCCGGTGACTCGAGCCAGGCAACTGGGGCTGTGGCCACGGAAATAGGCATGGACATACTCAGTGAAGGCTGTGGCCACGGGCAGGGCGCCTGAGATCCCAGGACCACGTGGGCTGGGGGCCACCGGGAGATGCCCATGTCCCATCTGGGTGGAGAAGCTAGGCCGGATCGGGGGGGATGGTGGGGCAGACCACATCAAAGACAGCTTTCACAGTTGCGG	49	59	290	300	10
2G5Z3:10459:12351	CATTATTTAAAATTATTAACCACTCATTCATTGACCTACCTGCCCCATCCAACATTTTCATCATGAGTAAACTTGGGTCCCTTCTAGGAGTTCGGCGATTAGTGTAATTAGTACGGGCTCAGGCGTTGGTGTTCAGGTATTAATTGCTTCAATATTAGGTCTTTTGAGTAGAACCCTGTTAGGAATGGTATTCCTGTGAGGGCGAGGCTTCCGATTACTAGGCATGATGATGTGAATGGTATGATTTTTGTGATGTTTTCCTATTTTTTCGGATGTCTTA	392	402	35	45	10
2S43D:04241:14324	CCGCTATTTTACAGATTAAAAAGAACTATTTGGAGCAGAAAGCCGTGGATGGATCAGCCCAAAGCCATAACAAATTATAAAGCCTACAACTCTATCCAGCAGTCAGACTCTTGGATCCTTAACAAACAATACTACATAATTTGGGCTAGAAAGGTAGCTCAGCGTTTGAGAGCACTGGCTGCTCTTCCAGAGGACCCGCGA	275	285	173	183	10
2G5Z3:07195:14955	CGCGGCTATCGTGGCTGGCCACGACGGGCGTTCCTTGCGCAGCTGTGCTCGACGTTGTCACTGAAGCGGGAAGGGACTGGCTGCTATTGGGCGAAGTGCCGGGGCAGGATCTCCTGTCATCTCACCTTGCTCCTGCCGAGAAGTATCCATCATGGCTGTATGCAATGCGGCGGCTGCATACGCTTGATCCGGCTACCTGCCCATTACACCACG	200	342	0	142	142
2S43D:08353:08245	AAGGGATTTGGGCAAGGAAAGGCACATCATTTCACCACAAGAAATAAAGACCCATAAATGGAGGTTAGTAGGTGGCAGCTACAGCTTTAGATCTTGTGGTGGTAGTACCCCCAGTAGTCAAATCAACTGTCTCTGAAACATTCATGAGCAAGCCCAGCATTGCTAAGAGGAGAGCGAACCAGCAAGAGACGGAACAGTTTTATTTCACGAAAATGATGGAGTACTTGGAGGGTAGGAACCTCATCACTAAGCTACAAGCCAAGCATGACATCCGTGTGAGTGCTGGGAATCAAACCAGGTCCTTTGGAAAGAGCAGTGAGTGCCTTTAACCACTGAGCCACCTCTCCAGCCGTCGGGTGGTTTCTCGTGGCAGTGTGTCCTTCCCACCTCTCCTCTCCTCGCTACCACCAGCGATCACTTTCTTAAAAGTTGACACTGTGCTCTGCCTCTGCCAACCTGGTGATCTGGTGTTTCTCTGAGATGAACTGCACACATTGAAGGGTTTCTATTTTTTACTGTGGGTTATTGCTTTTTAAAGAAACAATACATCTTAAAGCAACACTATCTATTTTATACATCCACAAGCAAAATTC	179	189	480	490	10
2G5Z3:04395:05827	GCTGGCCATGGTGGACACTAGCTCCTGGACTTCTTTCCGTTTTTTCACAGGTCGGAGCCGAGCATGTACTGCGGCGGCAGCACAGCGGACCCTTCAGCTAGTTTGCTGGAGCCAATGTCAGAGAGAGGCCTTGTATTACCATCAGAGACTCTGCTCCCCTCCTTCCCTCCCCCCGCTCCGTTTCCTACTTCGATTGGTGGGTAGCATGGTGGGCGTGTACAACGGCAAGACCTTTCCAACCAAGGTGGAGGATCAAACCAGAGTATTGATCGGCCACTTACCGTGGCGAGTTCTTCCATCACCTACAAACCCGTGAACGCAGCCCCGTGACCTCACCCACTAGCCCCTCTGCGACCAGTGAGCCTGAGTCTGTCTCAGCCACGGGAGAGGAGCTGACCTCTGAGGCAGGGGGGAGAGGACAGCTGTGAGAGTCAAGAGTCCTTAAAGGATGAAGAAGCGGATGAAGCCCATAATTATTCAAAAACACTATGCAAAGGAATGCAAGCTTAGAATCTCTGGACAAGAATCAAAGGAAATCATTGATGAGTGCCAGCCAGTTCGTCGGCTCAGTGAACCTGGGGAGTTGAGGCGAGAATATGAAGAGGAGATAAGCAGGGTGGAGGCTGAGCGACATGCACAACTTCATCTTGAAGGCGCGGAGCACTGTGCGTGAGATTGACCCCCAAAACGACCTAACCTCCTTCGAATTCGCTCCAAGAAAAATGAAATTATGGTGGCACCAGATAAAGAACTATTTCCTGATTGTGATCCAGAATCCAACTGAATAAGCCACTGTCTGGGCTTCCTGTGTCATTCCTTAATTTAATGTCCCCAATGGAGAAGTAGCTATTCTGGATTCTACAACCATTGAAATCTCAGAGCTTCCCATCCGAACGTGGACTCAGACATATAAAGAAACAGGTTCTAGAACCCATGTTAATGGAACTGAGAAGACACCCTCTCTAATAACAGACTAATAGGAAGTAACCATACAGATAC	615	625	849	859	10
2G5Z3:08154:04530	CACGTCGAAGACTTACTGACCTTCTACCTCCCTTCCCAATGGCTGGATTCATAGGCTCTAAGCACGATGCTCAGATCCACAAGATGCTAGGTTCAGATTCAGAGCCTCACTCCTGCTAGAGTGCTATCCCTGACACTTAGGCTTTTTTTCTTTTAAGTTTCAAGACAGGTTTCTCTTGATACCTGAAACAAAAATAAGCACAAAAGGTATAAATGCCTAATGGAGGAAACTGAAACCCATCCTGTTGATTCTTTAAATTGTAAGTGTTCTACTTTGTGACAGTACAGATTGGTAGACAGCCTAGTTTTTTTAGTGATCTTCAAAATTTTAATTTGGATCCGTTCTCCACCTGGCAGCGGCCAGACACCTGGTAGCAGGTGCCAGGTTCCAGGTTCTGCATCTCAACAGGAGTCAGCCCATCTGTCTTCAGCTGGGGCTCCAGCCGGGTCCATGTTTCAGCCTGGCATTCCTTGTACCGGAACTGACAGATGATGTGTATCTGTGTGTGTGTGTATCGTGTGTGTGTGTGTGTTGTGTGTGTGTACTCGTAAA	617	627	42	52	10
2S43D:02895:14498	TCAGAAACCTTTACAGAAATGGACTCTCACGAGGAGAAAGTATTCCGAGCAGTCAGAGAGACTCAAGAAACGTGAGGCTAAAGGCTGAGATGCGGCGTAAAAGCAAAGGGAATTACAACAGGCCCGAAGAGATGCAGAGAGACAGGA	337	347	33	43	10
2S43D:07550:10735	TGGGCGACCTGGAGACTCCACCTGTGCTGTATCACCAGAGTCAGAAATACTCGCGTCGTGCAGGACGTGACAAATGGAAGTAGCACGTCTCACTAGTCTCGTGCAGATGGACAGCACCGCTGAGCAATGGAAGCGGCCAATATGGGATCGGCCATTGAACAAGA	0	21	143	164	21
2S43D:00269:08866	CTCCCTACCCCATTTCTTGAAAATAGACATTGTTTAGATCTAAAAAGTCCCACCTCACGTTTCCCCCAAATGACCGGGAAGTACCCCAAACCTTATTCGAACTAACCAACCAGCTCGTCTTCTCGCTCTTCCACCCTGCTGTTCCAAAGCTGCAGGATCTCTATGACACAGCGCAGCAACAGGATAACTGGAGGGAGTCCTGATGAGGAGCCAACATTGTTGTTGTCACAGAAGCTACAGCTTCCACGACCTTAGCTTCTTGTTTTCTTTTGCGGTACTCTACAGGATACCTTTTTCCTTTGTCGGTGGGGTTCTGAGGAGCAGGATGGGACGTCCTTCCTCGTGCTTCACGATACATACTATGTAGTAGCCCATTTCCACTATGTTCTATCAATGGGAGCAGTGTTTGCTATCATAGCAGGATTTGTTCACTGATTCCCATTATTTTCAGGCTTCACCCCTAGATGACACATGAGCAAAAAGCCCACTTCGCCATCATATTCGTAGGAGA	303	313	151	161	10
2S43D:10459:07134	CGATCGCCGGTGCAGTCATGAGCCCCGCCTCCCCCTGGTGCACGGAGAGGGCGGGGCCTGGGAACAAGGCTGCTTCGTGACCCACTATGTCTTCCCCACAAGTTCTCCTGGACACTCCCGTGCCTCGGGAATGGGTTCTTCCTCAGCCAGTACCTCCGCCACGCCAC	560	570	74	84	10
2G5Z3:01661:03243	GCAAGATCACTGTCACTTCAGAGGTGCCTTTCTCCAAAAGGTATTTGAAATATCTCACCAAAAAATATTTGAAGAAGAACAACCTCCGAGACTGGCTGCGTGTGTCGCCAACAGCAAAGAGAGTTACGAGCTGCGTTACTTCCAGCACTAACAAATAATATACATACCCCTTCATCCTTCTCCTCCCTAATGA	274	284	89	99	10
2G5Z3:07442:05474	AAACCGTCTGTAACCCATCTTTGGGAATTTGATGCCCTCTTCTGGAGGTACCAGGCATGCATGTGGTGTACAAATATGTGAGCCAAACACTCATATACTTAAAATAAAAAGCTAGTACAATTAAAAAAAAAAACCACAGAAGACACCAGGTGACATATTTCTAGGTAGGCTCATACAATAAAAGCCTAGAAAGCCAATAGACATTATTGCTCATACTATTCCTATATAGCCGAAAGGTTCTTTTTTTCCGGAGTAGTAAGTAACTACATGTGAAATAATTCCTAAATCCTGGGAGGATAAGAATATAAACTTCTGGGTGCCAAAGAATCAGGAAGCAGATGCTGGTAGAGAATTGGGTCCCCTCCTCCAGCGGGATCAAAGAAAGTTGTGTTAGGTTTGTAGAAAGAGCAGCACAGCTGGCCATCAGAGTCACCAATCCCAACGCCAGGCTACGCAGCGAAGAAAATGAGTAGATGGCTGTGTGCATGTTTTATTGTTTAAATTAAAATACACAAAACCTGCAAA	141	151	235	245	10
2G5Z3:04357:00705	GTGCACATAGCGCAGGGGAGAATCTGGTGTTACACAGAGGCAATGGGTGGGCAGGTTGACATAAGAGGCCTCTGTGAGTGGCTGATGGTCAGCCCTGGGATCGGTCACCACTAGCAAGCCGTGGCTCCTAGAAGGCTGC	126	136	8	18	10
2S43D:09795:12083	TGACAGCCTGCCCCCTGGCACCGTGAAGCTCTAGGAGTGCCTGCTTGCCTTCCTGGCTGCTCACTGCCCCAGGGATGTGCCTGCTGCCACCACCACCTACACCACCTGCACCTGTGCCACGGAAGTCTGTGACAAGCCTTAACTTATGTGTTTGGACAAGCTGTGTTTTTGGTTTTGGCTATCGGTACACTGGTAACTCAGGCCACATTATCCACTGATGCCAACACGGCCAGTGCCCAGTTACATTCAGAGGCCGGACTATGCTGACCATCCTTAGGAATGTTCTGAATCGGAGCGGCTCTTAAAGGTACCTCTAGACTCGCAAGAAGCGGTGCTCTTTTGCCTGAGTCGAGTTGGGGTTGGCATCTGGGTACTTGGTGAGGTCGAAAGTCAGGACTTTGCTGATCACACAGTCCCCTTGCTCAGGATAGACTCCAATGAGGA	576	588	37	49	12
2G5Z3:08254:08775	TTCCTCTTGTTCGTCTCTCCTAAGGAGTTCGTGCAGAACGTCTCCCACCGCTCCCTGACTTCATCGGGAAGATCTTTGGATGAGCTGCTGTAGTCGATGCCATGTTCATCGCTTATCACCTCCCAGAACTTAGCACCGATCTGGTTGCCACACTGTCCGGCCTGGATGTGCACGATTTCCCTCATGCTACGGTTTACTACATCAAGAAGGTGGTGAAGCAGGCATCTGAGGGCCCACTGAAGGGCATCTTGGGCTACACTGAGGACCAGGTTGTCTCCTGCGACTTCAACAGCAACTCCCACTCTTCCACCTTCGATGCCGGATCCCAGACGTCACTCCAAACCTCCACTCCATATCAATCAGCTGGTTAACCATCAGGGTCTGACCCATGGCCCACTGTGCAAGGGTCGAGGCGTTCTGCTTCCACTTTCAGAAAAGTAAGTGGCTTTCTCCTCGCTAAGACA	563	574	382	393	11
2G5Z3:01521:11892	CTAACACATACAAGCACAATAGATGCACAAGAAGTGAAACCATTTGAACTATTCTACCAGTGTAATCCTTTATCATAATTGCTCTCCCCCTCTCTACGGCATTCTATATTATAAATTAGACGCCAGAATATACTGCAGTCACTGTAATTCGATAGGGGACCCCTCCTTTGAACTCCCCTGGTAACAATGTGCTGAGGTTTCCAGGGGGGAGACGGGTCCAGTTGAGATGAAAAGGTGCCGGGCCCTTCCTCCAGTGAGAACCAAGAGGGGACACTTACAGACTCTATGAAGAATGAGAAGGATGATCTTTATAAGGACAGTTCTGGAAACACCAGTGCAGAGAGCAGCCACTTCTTTGCATATCTAGTGATCCGCTGCCTGTTGTTGAGATGCAGAACCTGGAACCTGGCACCTGCTACCAGGTGTCTGGCCGCTGCCAGGTGGAGAACGGATATCCATGGGGCGAGTGGAGTTCGCCCCTGTCCTTCCAGACGCCATTCTTAGATCCTGAAGATGTGTGGGTATCGGGGACCGTCTGTGAAACTTCTGACCGGGAAGAGCTTCACTCAAGATTTCATGGTGCATTTCAACAGACTTGAACTTCAGGTTGTTACAATTGACTGGAGCAAAGGTAACCACCATGCCGAGGCTTGAGTGGTGCTGCTTTGATAATGTTGTCCACTCGCAGGATCACCTCTGCTGCTTCAGCCGCACTCAGAAGAACCTGTCGCTTCACTTGAAAACTCTCTGTTATACCCAGTACTGCCATATCGCCGATGGTACCTTCCTTCATATCCAGA	470	480	298	308	10
2G5Z3:09896:08090	CGATCTCCAACTGATTCGTCCGCTGGCTTGGTTCCTTAATCACCTGCATCAAACTGTTCAGGCCACGCCCCAAGAGCTCCTGCTTCAGTCCGAGCAGGAGTTGGAAGTCCTTAGTGTTCTGCCCCCTGGATGGCAGCCAGATGAACCCGTGGTCCCCAAGGCCATTTTCTTCTTGTGCCCTCCACCCGACGAAGTCACGGGGTACGGCATGGGCAGATGGTTAACCATCATGATGTGCTGGTTGGCCTGATACACGGCGGTGGGGGTCTGCACACCGGGACGGATGGAAGGACTGCTGTTTGGGATGGCAGCTCGGGGAGGCTGGATTTGAGGCCTCTGGAAAAACGGAGACCGGGCCTGAGGTTGTGAGTTCATTGTCTGAGGTTACGATAACATTGTAAATTTGGTCATCTCCTAAAAGTGCACCTGGTTGACCTAATTCTGCTCGAATTAAAATACTTAGTGCAGTACCCACTATTCCCGCTCCAGGCTCCGAATAGTAGATAGAGGGTTCCGATATCTTTGTGATTGGTTGAGAATAATCAACGA	445	455	280	290	10
2G5Z3:05778:10260	GTGGAGTCACACAGGCAACAACTTCACTGAAAGGACCTGCACCTACAACACTCATAGCCTGGACTCTGCAGTAATAGGTAGTAGCTGGTGAAAGTCCTTTTAATTCACAACTGAGAGCCAGAGCTAACAGAGAAACCCTGTCTTGAAAAAAAACAACAACAACAAAAAAAATCAAAAGAAAACAAAAACACAAAAAAACATATTTTGCCTTCCTTCCTTGCTCCTTTCCTTTTATTCCTTCCCTCA	324	334	215	225	10
2G5Z3:05050:05307	CCTGAATGAACTGCAGGACGAGGCAGCGCGGCTATCGTGGCTGGCCACGACGGGCGTTCCTTGCGCAGCTGTGCTCGACGTTGTCACTGAAGCGGGAAGGGACTGGCTGCTATTGGGCGAGTGCCGGGGCAGGATCTCCTGTCTCTGTTCTTTGTGGCTCATAGCTGTGGAGGACTTGGCTTTGTGAACTGATGTTCACGAGAAAGCAGATGTAAAATAAGGTGACTGTCTGTGCTACACGTAATTACTGTTGTACAATCTGCTCATCAGTCGTCACTGGATTTTCTTCATTTGTTGAATAGTCCAGGTGGTCCATCACCTGATAGCTGCTGCCTTTCCAGAACTTTTTCATTTCA	174	294	0	120	120
2S43D:01263:10935	AATACACCCCTGCTACCCGTTAAGAAACCAGGAACTAACGATTATAGGCCTGTCCAGGATCTGAGAGAAGTCAAACAAGCGGGGTGGAAGACATCCACCCCCACCGTGCCCAATCCCTTGCCGGCAGACTCGCCGCCATCGGGCCGTGTGATCGAGGGCACTCGCCCATCTCTCAGGACCGACTGACCCATGTTCAACTGCTGTTCACATGGAACCCTTCTCCACTTCGGCCTTCAAAGTTCTCGTTTGAATATTTGCTACTACCACCAAGATCTGCACCTGCGCGGCTCCACCCGGGCCCGCGCCCTAGGCTTCAAGACACTTCTCTAAATTTATAAGCATTCCCCAAATCTCTCCATTTTCTGGTTGTCTTTCAATCTTTAAAGGGATGAGGATAATAGACATAGTTGTATGTGCACAACAGAGGCACTGAACGCAATGGGGAGCAACAGCTGATCAAAGATGTCTGCCCACTAGGACAAATAGTAGTACTAGCATCTGAGTTTGGGA	79	89	415	425	10
2G5Z3:03362:01842	CCCGGTCACACTTCGGCTGGTCGTGCCCGCCACCCAGTGTGGCTCCCTGATCGGCAAGGGCGGCTGCAAGATCAAGGAGATCCGCGAGAGCACCGGGGCCCAGGTCCAGGTGGCGGGGGAGATGCTGCCCAACTCGACCGAGCGGGCAACGTTGGCTCTCGCATTATCCCCTGGCACGCTACAACATTGCATGTAACACACCCTGCCCAGTGTAGCATACACATTATAACGTTTATCTAGGACTTCCCCGAGTGTTTCACACAATGCCAGAGCTGTGTCTTACATGCTTGAGCTCCTCGTTCCTTCCGCAGTACCACAGAACGGGTTCGACCCCCAGGTCCCACCGCCTCAGTATGAAAGGAAGAGTTTATTGAGGAGTGGTATGACAGGCAGAGAGGATGCCCCAAGGTGTGGCTGGGGACAGCCATCGTCAGGGCTTAAGACAATCTTTTGAGACTAGTTGGTGAATTAAGGAATGTTTGCTCTGGAGGAAGAGGAGGCGGCTGCGGAAAGGGTCTGGGTCTGGGTTTGCAGATTAGGAGACAAGGAGTTGGTTACCGCTGTCACCAAAGCCAGCAGCTTTAGCGGAATCTCAGTCCTGACAAGAGGTGGATACAGCTACGTGGAAGCAGCAAAAATGCATGGACTAAGGCATT	368	378	58	68	10
2S43D:00478:12058	GTCGAGAGGTCAACGACTCATGAGAATTCCACTTATGGAGTGAATAGCAATGACATGATGAGCTGACAACTCTTCGGACTCTACCTTGCAGAGCAGCGGTTCCCCTTTGGTCTGGTGCCAGAGGGTCAACAGTTGCAAGGAAGGCCCGGTTCTCTGCAGCCTCCGCGGGCCACTTCCGGTCCCCCGCCGCTCCGGAGCGCTCGGACGCGGGTAGACGAGCTGCCCAGCGTGGCGATGCTCGCACAACTGCTTCACGTGGGGAGGTGGCCGGTGGCGCGGCTCATCAAAGGATGTGCACAACCTTATGATCCCACTTTTATGATGAG	137	147	143	153	10
2G5Z3:07056:13352	GTGGAGGTTTGTTTTTTTTTTTTTTAATATTTATTTACTTATTTATTAATATGTAAATACACTGTAGCTGTCTTCAGACATTCCAGAAAGAGGGCATCCAGATTTCGTCCAGATAGTAGGACCCGTCGCTCGTCTTCTGGGTGGTATTACACAGGGCCTGATGGGTTTTGGGAACTGCTCCTACGCAGAGTCCCCTGTCCGGTCACTTCGGACAGGGTCAGCTTGTGTTGGGAGGCCACGGAGCA	162	172	193	203	10
2G5Z3:00958:10199	GGAGCTCCGCAGTCACCGACGGGACCAGAAGTGGCATGACAAACAGTACAAAGAAAGCCCAACTTGGGCCACAGGCCCTGAAGGCCCAATCCGGTTTGGGGGTGTCCGGTCCTCACTGCAAAGGGGAATTATGGCTTGGAAAAAGTAAGAGAAGAACCTTCTAACCCTTTCCTGGCGTTTGTGGAGAAAGTGGAACACAGCCCTTTCAGCAGCTTTGTGTCTCAGGCATCAGGTAGCTCTTCCTCTCTACCTCTGTCACCTCAAAGGCAACAGCCAGCTGGCCTGAGTGTTTTTGTTCCCATGTTAAAGATAGAGTAAATGCAGTATTCTCCACATAGAGATATAGACTTCTGAAATTCTAAGATTAGAATTACTTACAAGAAGAAGTGGGGAATGAAGAATGAAAAATTACTGAGGGAGACAGAGGCAGGTGGATCTCTGAGCTCAAGACCAGCTTCATCTACATAGTGAGACGCCCATCTTGAAAAAGGATGAAGTTACCCTCTCTCCTTCTCTTCTCTCTCTCTCTCTCTCCAGGTACTGCAGCAGCTTGCTCATGCTGGACACCGGGGATGCCAAAGGACTGCACGAAGAGCAGCAGCTGCTGGGGCCTCCAGGTCCGTATACCCCAAGACCCTGTTTTAAGAGAGTAATACAGGAGAAACTAGATTGGTTGTCACAAAGTGGGCTCTTCCCTCGTGGTGGGAATGCTTATAACTACTAACTCTGCTCCAGTGGAGCAGGTTCCCGGGGGAAGCCTGCCTGCCCCCGTCCCCA	482	492	587	597	10
2G5Z3:04006:09709	CCCTGGCGATAGTGGTCTTTCCTTTGATGCTGAGACTGCCAAGGCACACAGGGGATAGGCATTGGTCTCAACTCCTCTGCCATCTTCGCTTCAACAATCTCAGTTAGTATCTGGTTGTCATTCTTGTGCTCTGCTTCTTCTTGCTTTTCGACCACCATATCCATGGGTTCCTCATCTGGCTGTTTCA	403	414	146	157	11
2S43D:08581:03746	GGACTGGCTGCTATTGGGCGAAGTGCCGGGGCAGGATCTCCTGTCATCTCACCTTGCTCCTGCCGAGAAAGTATCCATCATGGCTGATGCAATGCGGCGGATGATATTGTGTCAGCAGACGTGGAAGAGGTTGAGGTGGTGGAAGGCGTGGCTGGAGAGGAGGATCATCATGATGAACAGGAAGAGCACGGGACCCCTCCCCTTTTTTTTTTAATTTGGATACTGTCTCTGTGTCCTTTAGTTAGTTTGGCTAAGGGTTTATCTAACTTATTAATTCCTCAAAGAACCAGATCTTTGTTTTGTTAATTCTTTGAATTGTTCA	273	373	0	100	100
2G5Z3:00153:08702	GGCAGCAATAAGGGAAATGGGGTAATGGCCCAAAAAATAATGGTATGTGTGTGTATGGAAAGAAGGGGGTGCAAAAGCCAAAGGGAACGGTGGGGGGAAGGGACAGATGAGGTCAGGTACTGGGACGCCGCAGGTGAGAGGCCATTTCATAACAATTCTGCAAGACCTGACCTCGTTCACCTGGGAAACCCAGATTATATTACGGGAAAGTAAACTTCTCCAAGCGGTGGCAACAGTTTCAACATAATTTGGACAGCATGCGGATGCTTCCAGCAGGCGCACTATGAAATCCGGAGAAACGACGACAGGACTGTGAGCACTACAGGAAGAAACTCGAG	267	277	94	104	10
2G5Z3:05309:08789	CAACGCGCATGCCCGACGGCGATGATCTCGTCGTGACCCATGCGATGCCTGCTTGCCGAATATCATGGTGGAAAATGGCCGCTTTTCTGGATTCATCGACTGTGGCCGGCTGGGTGTGGCGGACCGCA	572	648	41	117	76
2G5Z3:06719:09519	CGCTCGTGCTCCACCTCCCCGGCGCGGCGGGCGAGACGGGCCGGTGGTGGCGCCCTCGGCGGACGTGGAGAGGCCTCGGGATCCTGATCATCAAGCCTCACGAGCCACGAGAGCACAGGAAGAAGGCAAGAAGAACCCCACCCGCCCCATCATCTCCAAGACCCCCTCGTGATGTGGAGGAAGAGCCACCTGCAAGATGGACGCGAGCCACAAGCTGCAACTGGTGAAACCCGGGCACGTCCGAACCCGGATGCCCAACCGGCCCGCCGGGACTGTCCGAGA	52	62	64	74	10
2S43D:06176:04467	CTCGTCTCGTGCTCATGGCCAGGAGCTTGGATCCATACACTCCTGTTCCCCTTCATCAGCTGCACATCGTGTCAACAGCCGGGTGCGTAAGCAAGCTGAACATTTTGAAACTGGCTCCTGGTGGGCATGTGGGCCGTTTCTGCATCTGGACGGAGAGTGCTTTCCGGAAGTTGGATGAGCTGTATGGCACTTGGCGGAAGGCTGCTTCCCTCAAGAGTAACTACTAACCTGCCCATGCACAAGATGATGAACACCGACCTTAGCAGAATCTTGAAAAACCCGTAAATGTCTCTGAACAGCATGGGACACAGCAACAAACTGGATTCTTGTTCCTCTGTCAACCTCACTTGAGCCCTGGCCAA	394	404	226	236	10
2S43D:03232:08414	GTCCGCTCCTGTCTCTTTGCTTTGAGTTCTCTGTGCTGCCCAAGCAACAACGAGTCGGCATGTATTAGCTCTAGAATTACCACAGTTATCCAAGTAGGAGAGGAGCGAGCGACCAAAGGAACCATAACTGATTTAATGAGCCATTCGCAGTTTCACATGCATTAAGATGTTGCTGGGGACTTGCGGACTCCGCCAGCCATATTTTATACTTGGGGAACGGTTGCCGGTACTAGCAGGAGGCGGCTGCAGCAGCAGCAGCTGCAGACGTGGACCCATTGTCTGTGTTGATATGAACACCAAGCAAATCTTTTGCGCCAAGATCTGATGAGACGCCAGGAAGAATTAAGGCGCATGGAGGAACTTCACAGTCAAGAAATGCAGAAACGTAAAGAAATGCAGTTGAGGCAAGAGGAGGAACGGCGTAGACGAGAGA	368	378	238	248	10
2G5Z3:08893:10239	TCATGGTGCCCCGCCTGCCTGGCATAGCGATGGGTGTGCGGCCATTGACATCAGGAGACCCGGGGTCAGCCCCATACACTACCAGCAGCTCAGCTGCAGTGTCTGCCCTGCTGCAGCCACATGTAGAGTGTA	5	15	38	48	10
2G5Z3:06891:11617	GCCGTACCCTGACAGCAGTGCACGACGCCATCCTTAGGACTTAGTCTTCCCCAAGTGAAATTGTGGGTAAGAGGATCCGTGTGAAACTGGATGGCAGCCGGCTCATAAAAGTTCACTTAGACAAAGCACAAGGATATTGATTCAGTCAAGTACTTGGAATGTTCTGCACTCACCCAGCGAGGCCTGAAGACCGTCTTCGATGAGGCAATCCGCGCAGTCCTCTGCCACAGCCACACGCAGCAGAAGCGCCCTGCAGCCTGCTCTAGGGTGTCACCCGTCCCTCCCCAGGCTGTAGGAGCAAGGCATAGCCGACGGCAAAAGCATCCACAGATGCTAGCCCCACCCTGGGGAAAGGGAGCCAGAAGCGACAATACGTTCCTTTTGATAGTCTTGGCATTTGCAGAGTGGACCCAGCAGTGCCACAGTTATGCGCTGAGCCCGGCCTGACACCCAAGGCTGTTAAGGAGGATCTATGTTCCGGAGATAAGACTCAGAGTGCCGCCACCTGGCTACACACCCAAACACACATAGAGGACTCTGGAGCCGCAGTGGGACAGCCCTGCCTGCTTGTTCTTCTGAACTTGGGGACCATGCCTCTTTGGGCTCTGCTTCCAGGATGGTTTGGGAAGCATAGCAGGGCACGGCTCGGCTCCTGAGATCCATCCCCCTAGACTGACTGACCGACA	576	586	560	570	10
2G5Z3:02719:13780	TCGGCGCTGGGCTCTTCCCTGTTCACTCGCCGTTACTGAGGGAATCCTGGTTAGTTTCTTTTCCTCCGCTGACTAATATGCTTAAATTCAGCGGGTCGCCACAATCAGACGTCCCCGCCAACTACAAGGTCATAAAGTCCAGCAGTGACGCCCAGCTGTCCCGAAACTCCAGTGACACGTGCCTGAGGAACCCGCTCCACAAACAGCAGTCTCTCCCTCTCCACAGCTGACGGATACCCAGATCAAAAGAAGCACCTCTTGTAATCAGAGAGGGTGCGGCCATCTTCCAGCTGCTTGCCGGCAAGATCAGCCTCTGCTGGTCAGGGGGATGCCGGTCCTTTATTCCTCGGATCTTGGCCTTCACGTTCTCGATGGTGTCACACCCACACCAGGCTCCTGAGGACAAGGCTGTCCACCTGACTGATGACAGTGCACAGTAGTGATGGTGTGCTCCGGGTGTGCTGCCCAGTGCTCAGTCCACCTTTTCCACCATTCCGTACTTGCCGGCTAGCCGCATACCCGCGGGGCTGGAGAACCGGCTGTGTGCGGCCACAGCCACCATCCTGGACAAACCCGAAGACCGCGTGAGCGTTACGATACGACCTGGATTCTCTTGCTGGTAAAATCACTGGCATGCTGTTGGAGATTGATAACTCAGAATTACTTCACATGCTCGAGTCTCCAGAGTCTCTCCGCTCAAAGGTTGATGAAGCTGTAGCTGTACTACAAGCCCACCAAGCGAAAGAGGCTGCCCAGAAAGCAGTGAACAGTGCCACTGGTGTTCCAACTGTCTAAATTGATCAGA	408	421	731	744	13
2S43D:06765:02649	CTGCAGTAGGTTAGTATGTCCCCTGCCTTAAACCTCAGCACCATGTGCCTTGCAAGAAACCTCGCCTCTCATAGACCACAGCTACCTACTTCCCCTTAAAGGATGTAGTTTTCCATGAACGAGAAGACTAGAGTTGGGTATTAATGTCCTGTATATCCTTAGGTTCGTTATATTGATCAATGACCAGATAAAAAATCAAAACTGGCTGGCCAGGCAGCCGCGGCGGAGATAAGGATAGAAATGAGAGGACGCCAAATCGCAGCTTGCAGCACCGGA	211	221	202	212	10
2G5Z3:03456:05471	GGCTACTCTCCCCTCACTGTTCATCTCTGGGCTCAGTGACTTTTGTTCCCACTACCTGGCTGATGGGCCTGTCATCTTCCTGGACTCTGCATCCATTGGACATTTACTGTGGCCTTTGGCTAGCCTGCGGATCTTGGTCAGCTCTGTCATTCCAT	312	322	67	77	10
2S43D:06196:08517	GAACAGTACATGTTATGACCAAAGAGCCCTTTCCAGTGTGGCCCCCAGTCCTGGGCCTGTGTCAGTGCTCTAGGCCACCACAAGCACTAGTCACAGACACCGTTACCCCGTCGTCGCGGCCATCCACATTGCAGCCCACAGACTGTGCAGTACCCAGGATCTCCTTGATAGTTCCAGAAAGTTCTCTAGCCAAAGACCGGTGTCTCATCTGCCGGGCAATGTTGACAATCTCATCAAAAGTAATA	304	315	154	165	11
2S43D:00896:02153	CTGACCGGCGTACCCTCATGAAGTACAGCCAGCATAGCCACAAGGTACGCAAATAACTGTTTGGTATTTTGATGCAGATGAGCGAGCGAGAGACTAAGTAAAAATATCTAACAGGTGAGAAAGGTGTGAGGGCTTGACTTCGCAAAAGTGGAGTAGGCAACATATTCATTAAAAATTTGGACAAATCCATCGACAATAAAGCACTATATGATACGTTTTCTGCGTTTGGTAACATCCTTTCATGTAAGGTGGTTTGTGATGAAAATGGACTCCAAGGGCTATGGATTTGTACACTTTGAAACAGCCCAAAGGTGAGATTTTATAGCATAGCTTTGGGAACAAAGTGGAACTGATACATATAGACGTAGCATACATACACAGGCATGTACTCAGGAATGCATAAACACACATGTGTGTGCACACATACAAACATCAGCGGTTAGGAGCAAGCACTAGCAATTGCTGCTGTAGCAGAGGATCTGGCTTGGGTTCCAAGCACCTTCTTGTGGCTAACAATTGTCTGTAAACTCTAGTCACTGGGGTTCTACTACTCTCTGGCCTCTATCTTGGGCTACACTGAGGACCAGGTTGTCTCCTGCGACTTCAACAGCAACTCCCACTCTTCCACCTTCGATGCGGGGCAGGATCCAAATCCCCCTGAAAATTCACACAAGGGCG	299	311	636	648	12
2G5Z3:09160:11039	AGAAAACTAAGCATTGTATTTTTTTAACAAATCTGAGAAAGCACTATGAACTGCAGGTGTTTGACTTTCAGAATATATTTTGTATTGTTAATACTCACATTATGTGAATACTGGACGCTGCAGATCTTTGTAGGCCGCAGTCCAGTTGAGCTTGTCCAGGCTGTCACCATCTTGAGCCCAGTCCACCACATACTCCAACGGTTTCCTGGTCCCTTGTTTCCAGGTCACCTTTATCCCTGGGCTCCCATCAGCACTGCTCACTCCACGTCACAGGGTCGGAGTGCTGTCAGGCCTGTGCTATGCCCTGCTCTACCCTGGCCTGTCAGGTGCTTTCACCTACCTGGTGGGGGTCTATGTGGCCCTCATCAGCTTCATGGGCTGGAGAGCTATGGCAGGGCTGCGGTTGGTTGGGGCAGCCTGGCGGTGGACAGAGCTGGCGGCCGGCGGTGGTGCTCTGCTCTTCATCCTCTCGGACCTGACCATCGAAGTCTTTGAGCCGCCTGCGGACATGGTCCGGGAGCGAGCCTGCCGGGGAGGCAAGCGCAGGCACTCGGCGTGGAGCTGTTCGCGCTGGCATCTTGCAGGTTGCAGACGACAGAACAGCTCTGAACGAGATCATGCCCAGCCTCTATCAGCAGCAGCCGCAGACC	179	191	45	57	12
2G5Z3:01732:03783	CCTCCCCTTTTCCTTTTCCTTCCTTTCCTTCTCCATTTAATATGGTTGTATATTAGTTGGTTTTTCCCAGAGTTGGGCTGGCAGGTGTCCCACTTTTCTATGTAGTGTAATTAGGAAATAAATCCAAGCACTAAGCTGGAGTCCCAAGACAAAAAAACTGAAACATGGACCCGGCTGGAGCCCCAGCTGAAGACAGATGGGCTGACTCCTGTTGAGATGCAGAACCTGGAACCTGGCACCTGCTACCAGGTGTCTGGCCGCTGCCAGGTGGAGAACGGACGGGGGGTCAAAACAGTGCAGCAGCAGTGGACAGGTCAGGTTGGGTCGGGCAGCGCAGGGGACAGAAGCGGTAGGCAGGAGCCAGAGCCCTGGGGCCTCCCTTAGCAGTAAACAATTCTGTCCTCTTTAGGAGCATGCTTTAGTGACACAGAAAACTACTGCGACAGGAGGCGGCATAACGATGGAAGTGTTCAGAGGAATCACGTAGCACTTGTCCAGGTTAAGGTCCAAATAAGCAGTGAGTTTCTTGTTGAAGTCGTGCACAATGTTGGCAGGATCGCTGTCCGCAAACTCTGGTACAGGCACACTGATGAATTCACTTGATGAAACTGCTGCCAAAGCCAAGGAAGTTCTGTTAAAAATCCTGAGACTCTCCATTCCTCATCCTTAGGAAGGTTTAGACAACTGGAGTCTTCTCCCACCCTGTACCCCATGTGTACCCCAGTTGACTACACCCCTCTCCCC	125	136	329	340	11
2G5Z3:09327:11078	GAGATACAGAAGAGATGACGACAGAAGTAAACACTTACCAGAGCAAAAATTGGAAAACCAGCATCCAGAAAGTTAATCAAAGTTGAAAGACGGCTTTGCCCATGCCTATCTGAAAACAGACCTTTCATACTGCACATAGAGACTGGGAGGGGGAAAAATGAGCGGACTTGGGACTGATATAGGAACCCTCTCCACATGAGTAGAACCTCGAAGGCTGGGTGTTCTCTTTAAGAGGCTCGTTCAGTTCAATACTGTGGAAACCAAGCTGGTAAGTGACAGCGTCTGCCACTGCTTGGGTATCAGCGGCTGAGCCTGAGCGGCAGCAGAAGATGTGATCGTGGATAGGGGTCACTTGTCAGTCACTCGATTGGCGTGTAGGACCAGTGA	638	648	212	222	10
2S43D:04051:10475	CATCAAGGATGGCAAACTGATCAAGAACAATGCATCTACTGACTATGACTTGTCTGACAAGAGCATCAACCCACTGGGTGGCTTTGTGCATTATGGTGAGGTGACCAATGACTTCATCATGCTCAAAGGCTGTGTGGTGGGGACCAAGAAGCA	485	495	58	68	10
2G5Z3:06538:04088	GAGAAAACAGAAGGATATCTATCATCATCAATGCTTCTGCTCCACCCTACACTGTACAGAATGAACTGAAGCCCCGAACAAATAGAGCAGCTCAAGCTGATCATGAGCAAAACGATATGATGGCAACCAACAAGCACTTGACCTCAAGGGCACCACCAGTGGTACACTGTGCTTGATTTAAAGGATGCCTTTTTCTGCCTGAGACTCACCGGGTCTCTTCAGGCTGATCTTAAGCTTTTAATCCTCTTGCCAGAGCCTCCTTGTGCTGGCATAAAACACTTTATGTTATCTGGGATTGAACTCAGAATCTTGTACATGATAAGCCAGTACACTGAGCACACCCACGCTCCTCACTGGGGGATTCTAGGCAGGGGCTCTACACTGACCACACCCCAGCAAGC	177	187	58	68	10
2S43D:06355:09181	GGCTTCTCTTGGGTCCGTGGACTCAAACTTGCGGGTGTAGAGCATGAGCAGACGCACAAAGTTCAGCCGTCGCATGCAGGGAGGGTCGCCAGGCTCGTGGCTGAGGAGTTGAGCACTCTGTCAGAGGACTTTAAAAGCAAGCTTTAGCTCAAACAGCACCAGGGCCACATGGACAGCATGGCAGCGCAGCCGCTCCATGACGGAAGAGAACGGCAATGA	518	529	85	96	11
2G5Z3:04841:05671	CTGCAGTTCAATGACATACCAGTGTGTCTCAGGCCCACACGGCTGGGCCCCGAAGCTAGGCGCTTATAGCCTGGTTCTACTCCTCCTTAAAGTCGCTTCTACTCAATGAAGCAGTGGAGCAAAAGGAACCTGGTGGAAACCTTGCTCATCAGCTGGGGAAATTTGGCACTCGGATGTCCAAGGGCTTGGGAGCAGAAAGTTGGTGATGACAACTTGAAATTATGAGGTTTTAGGGTTCGTACATGGTTTGGATTAAGATAGTAGGGCAATGGACTCTGGCTACTTCCTGGAGGTGAAGTCACACTGACCACATCTGAGACACCCTCCTACCCCCAATCATGCCAGTCAGTTCGTCCCCAGTAAGTCTCAGGACTGACCACCACAGGCTTTACAGGAAAGTCACCTGAGTGCTGACCTCGATTCCTTGTTCACAAACCGCTCATGCCACCCATACTTTTCTTCTGTTTCTGTACCTGGATCAGTCCCATCACCACCTCAGCACTCATCAGCTTCATATCCATCATTCCATCTGTTTATTCTGCATTAAAGACATGCAGAGTTTGAGGCTGTAAGCAGCATTCCTGGGAACATCATTAGATTCCAGGTAATAGTCTTCTACAAACAACACCAGTCTC	344	354	514	524	10
2S43D:04924:00205	ACATTCTAGAGCTCTTCGGATCTATTCTCCCACTGGACTTGGAGGACATCTTTAAGAAGAGGAAGACTCGCTACCACAAGCGCACTAGCTCTGCTGTTTGGAACTCACCACCCCAGGAAACGCGGCATTCACTGCGCCATCGATGCGTCCCAGACCCCTGACATCGTGTTTGCGAGCATCCTGGCAGCCTTCTCCAAAGCCACATGTAAAGACCTGGTCATGTTTATCTAATGTTGGGTCTAAAGGCTCTCTCTCCTGTCAGGAGGGAAGAAACCAGAACTGAAACTGGGTCCTAAGGCTCGGACTTTCCCACCCTGTTAGACTGGCAAGAAGGAGTGGTAACTGGTTAGGACCCTTGCCAGCCATCCAGGAAATCCTGGAAGTCTGCTGTTGGTAATACCCTGCACAGATAGAAACGTTCCCGCCAAAGGACAATACGGACCCAGAAAAGCCGGGTGCTCCGATCCTCAGGCTTGAGGGTCTCATGCCTCACACGCTGCACCTGCCTTGAATGAGGCGGTGGATGGGAACTTGCTGTGGGTCCTTCATCTCTGCCACAAAAATCTTAGTCACAGACTGCCTCGGCTCGCTGGAACCATGTGTGGGTCGGCGACTGAGACTGCCAAGCACACAAGGGGACTAGG	309	319	251	261	10
2S43D:03695:01808	CATGCGATGCCTGCTTGCCGAATATCATGGTGGAAAATGGCCGCTTTTCTGGATTCATCGACTGTGGCCGGCTGGGTGTGGCGGACCGCTATCAGGACATAGCGTTGGCTACCCGTGATATTGCTGAAGAGCTTGGCGGCGAATGGGCTGACCGCTTCCTCGTGCACCAGCCCACCTGCAGGCTGGGTCCCCATACTCCTCGCCTCCTCCCAGATAAACAAGTATGTCTGCGTGTGAACATTCTGCCTTCTGCTCTCGTGCCAGATCTTCTCCATGTCGTCCCAGTTAGTGACAATGCCGTGTTCGATAGGGTACTTCAGGGTCAGGATACCCCTCTTGCTCTGGGCCTCGTCCACCCACGTATGAGTCTTTCTGGCCC	572	648	3	79	76
